㐀	(丘|㐀|丠|坵)
㐅	(五|㐅|伍)
㐫	(凶|㐫|兇)
㐮	(襄|㐮)
㐯	(庸|㐯|𠆌)
㐱	(鬒|㐱)
㐴	(攀|㐴|扳)
㐵	(儒|㐵)
㐽	(偑|㐽)
㑁	(𠭴|㑁)
㑄	(侮|㑄)
㑇	(㑳|㑇)
㑈	(倲|㑈)
㑌	(尩|㑌)
㑔	(㑯|㑔)
㑝	(𢙱|㑝)
㑩	(儸|㑩)
㑯	(㑔|㑯)
㑳	(㑇|㑳)
㒇	(儛|㒇)
㒋	(厮|廝|㒋)
㒓	(𠉂|㒓)
㒚	(文|穩|㒚|稳)
㒞	(儶|㒞)
㒰	(全|㒰)
㒲	(財|㒲|才|财|纔)
㒷	(興|㒷|兴)
㓁	(网|㓁|網|罔)
㓟	(披|㓟)
㓥	(劏|㓥)
㓨	(刾|㓨|刺|莿|刺|朿)
㓮	(彫|雕|㓮|鵰|凋|琱)
㓷	(劓|㓷)
㓸	(斲|㓸|斵)
㔉	(劚|㔉)
㔍	(䥷|㔍)
㔱	(斞|㔱|庾)
㔾	(卩|㔾|節|部|罇|节|墫|樽)
㕑	(厨|𢊍|㕑|廚)
㕚	(爪|爫|㕚)
㕞	(刷|㕞)
㖈	(䎛|㖈)
㖊	(噚|㖊)
㖞	(喎|㖞)
㗖	(啖|啗|噉|㗖)
㗲	(𠵾|㗲)
㗳	(嗒|㗳)
㘅	(啣|銜|㘅|衔)
㘎	(㘚|㘎)
㘚	(㘎|㘚)
㘽	(㦳|㘽)
㙮	(塔|㙮|墖)
㙳	(轗|㙳)
㚝	(奎|奞|㚝)
㚣	(姣|㚣)
㚯	(㜄|㚯)
㛀	(媰|㛀)
㛛	(娠|㛛|暖|煖|諼|谖)
㛟	(𡞵|㛟)
㛠	(𡢃|㛠)
㛣	(㜏|㛣)
㛤	(孋|㛤)
㛿	(𡠹|㛿)
㜄	(㚯|㜄)
㜏	(㛣|㜏)
㜢	(𡞱|㜢)
㜷	(𡝠|㜷)
㝃	(娩|㝃)
㝛	(宿|㝛)
㝵	(碍|礙|㝵)
㞐	(居|㞐)
㞞	(𪨊|㞞)
㟆	(㠏|㟆)
㟗	(豳|邠|㟗)
㟜	(𡾱|㟜)
㠊	(嶇|㠊|岖)
㠏	(㟆|㠏)
㠯	(以|㠯)
㠶	(帆|㠶|拚|抃)
㡘	(𢅏|㡘|簾|帘|簾|𢅖)
㡿	(斥|㡿)
㢝	(𢋈|㢝)
㣶	(邅|㣶)
㣺	(心|㣺|忄)
㣼	(忍|㣼)
㤒	(笨|㤒)
㤘	(㥮|㤘)
㤵	(慈|㤵)
㥃	(悶|懣|㥃|闷|懑)
㥮	(㤘|㥮)
㥵	(慁|㥵)
㦎	(𢛯|㦎)
㦧	(憯|㦧)
㦳	(㘽|㦳)
㧃	(收|㧃|収)
㧏	(掆|㧏)
㧐	(㩳|㧐)
㧑	(撝|㧑)
㧖	(扼|搤|㧖)
㧜	(擸|㧜)
㧟	(擓|㧟)
㧰	(擽|㧰)
㨉	(抿|㨉)
㨗	(捷|㨗)
㨨	(㩅|㨨)
㨫	(㩜|㨫|擥|攬|揽)
㨼	(撂|㨼)
㩁	(搉|㩁)
㩅	(㨨|㩅)
㩜	(㨫|擥|攬|㩜|揽)
㩳	(㧐|㩳)
㩹	(𢶣|㩹)
㪅	(更|㪅|更)
㪯	(舉|㪯|举|挙|擧)
㫃	(偃|㫃)
㫎	(幑|𣄈|㫎)
㫚	(昒|曶|㫚)
㬅	(曼|㬅)
㬱	(朁|㬱)
㬹	(踭|㬹)
㭎	(棡|㭎)
㭏	(椲|㭏)
㭣	(𣙎|㭣)
㭤	(樢|㭤)
㭨	(椰|㭨)
㭴	(樫|㭴)
㮣	(槩|槪|㮣|概)
㯃	(桼|漆|㯃|柒|七)
㯭	(樐|櫓|㯭|艪|橹|舮|舻|艣|艫|櫓)
㯶	(棕|㯶|椶)
㯽	(檳|㯽|梹|槟)
㰍	(櫳|㰍|栊)
㱩	(殰|㱩|𦢌)
㱮	(殨|㱮)
㱿	(壳|殼|㱿|殻)
㲒	(勽|㲒|菢)
㲓	(毧|㲓)
㲿	(瀇|㲿)
㳄	(涎|㳄)
㳔	(濧|㳔)
㳕	(灡|㳕)
㳠	(澾|㳠)
㳡	(濄|㳡)
㳢	(𣾷|㳢)
㳽	(瀰|㳽|彌|弥)
㴑	(溯|㴑|泝|遡)
㴔	(潝|㴔)
㵒	(沸|㵒)
㶉	(鸂|㶉)
㶶	(燶|㶶)
㶽	(煱|㶽)
㷉	(熨|㷉|尉)
㷠	(燐|粦|㷠|燐)
㷻	(煳|㷻)
㷿	(𤈷|㷿)
㺍	(獱|㺍)
㺏	(𤠋|㺏)
㻅	(璯|㻅)
㻏	(𤫩|㻏)
㻘	(𤪺|㻘)
㽣	(域|㽣|譽|誉)
㽽	(痼|㽽)
㾙	(脪|㾙)
㿟	(皎|皦|㿟)
㿧	(𤽯|㿧)
㿷	(糙|㿷)
䀋	(鹽|䀋|塩|盐|𥂁)
䀠	(瞿|䀠)
䀢	(瞬|䀢)
䀥	(䁻|䀥)
䀹	(睫|𥅴|䀹)
䁖	(瞜|䁖)
䁪	(𥇢|䁪)
䁻	(䀥|䁻)
䂀	(𥋟|䂀)
䂫	(夯|䂫)
䂵	(碽|䂵)
䃉	(珉|䃉|玟|砇|玫)
䃘	(硜|䃘|硁|踁)
䄃	(殃|䄃)
䄍	(蜡|䄍|蠟|蝋|蠟)
䄯	(𢆞|䄯)
䄺	(稊|䄺)
䅉	(稏|䅉)
䅪	(𥢢|䅪)
䆋	(秋|龝|䆋|秌|穐)
䆔	(竉|䆔|𥥅)
䆫	(窓|窗|䆫|牕|窻)
䇲	(筴|䇲)
䈇	(罩|䈇)
䉙	(𥬀|䉙)
䉤	(籔|䉤|藪|薮)
䉬	(𫂈|䉬)
䉲	(𥮜|䉲)
䉵	(籑|饌|䉵|馔)
䊜	(糰|䊜)
䊭	(𥺅|䊭)
䊷	(䌶|䊷)
䋙	(䌺|䋙)
䋚	(䌻|䋚)
䋲	(繩|䋲|縄|绳)
䋻	(䌾|䋻)
䋿	(𦈓|䋿)
䌈	(𦈖|䌈)
䌋	(𦈘|䌋)
䌖	(𦈜|䌖)
䌝	(𦈟|䌝)
䌟	(𦈞|䌟)
䌥	(縯|𦈠|䌥)
䌫	(纜|䌫|缆)
䌰	(𦈙|䌰)
䌶	(䊷|䌶)
䌷	(紬|䌷|綢|绸)
䌸	(縳|䌸)
䌹	(絅|䌹|褧)
䌺	(䋙|䌺)
䌻	(䋚|䌻)
䌼	(綐|䌼)
䌽	(綵|䌽)
䌾	(䋻|䌾)
䍀	(繿|䍀|襤|褴|襤|褓|緥)
䍁	(繸|䍁)
䎛	(㖈|䎛)
䏕	(飪|䏕|餁|饪)
䐰	(饈|䐰|馐|𦟤)
䒒	(苕|䒒)
䓕	(薳|䓕)
䔛	(檾|䔛)
䕌	(稚|䕌|稺|穉)
䕳	(𦰴|䕳)
䖈	(虐|䖈|乇)
䖍	(虔|䖍)
䖏	(処|處|䖏|嗻|处)
䖟	(蝱|䖟)
䖣	(蚤|䖣)
䖵	(蜫|䖵)
䗖	(螮|䗖|蝃)
䗿	(𧉞|䗿)
䘑	(脉|䘑|脈|衇)
䘚	(卒|䘚|卆)
䘛	(𧝞|䘛)
䘞	(𧜗|䘞)
䘺	(綻|䘺|绽)
䙊	(𧜵|䙊)
䙌	(䙡|䙌)
䙓	(襬|䙓)
䙝	(褺|褻|䙝|亵)
䙡	(䙌|䙡)
䚎	(𥅾|䚎)
䛡	(話|䛡|话)
䛻	(誘|䛻|诱)
䛼	(譭|䛼)
䜀	(䜧|䜀)
䜊	(嘈|䜊)
䜣	(訢|䜣)
䜤	(鿁|䜤)
䜥	(𧩙|䜥|誕|诞)
䜧	(䜀|䜧)
䜩	(讌|䜩|宴|燕|醼|鷰)
䜶	(豇|䜶)
䝋	(豵|䝋)
䝙	(貙|䝙)
䝜	(狻|䝜)
䝤	(獠|䝤)
䝻	(𧹕|䝻)
䝼	(䞍|䝼)
䞈	(𧹑|䞈)
䞌	(𧵳|䞌)
䞍	(䝼|䞍)
䞎	(𧶧|䞎)
䞐	(賰|䞐)
䞓	(赬|䞓|赪)
䟢	(躎|䟢)
䠱	(躅|䠱)
䢀	(𨊰|䢀)
䢁	(𨊸|䢁)
䢂	(𨋢|䢂)
䢙	(敗|䢙|败)
䢨	(𨑹|䢨)
䣩	(醇|䣩)
䤍	(𨢥|䤍)
䥀	(捵|䥀)
䥇	(䦂|䥇)
䥑	(鿏|䥑)
䥨	(鑢|䥨)
䥩	(𨱖|䥩)
䥱	(䥾|䥱)
䥷	(㔍|䥷)
䥺	(釾|䥺)
䥽	(鏺|䥽)
䥾	(䥱|䥾)
䥿	(𨯅|䥿)
䦀	(𨦫|䦀)
䦁	(𨧜|䦁)
䦂	(䥇|䦂)
䦃	(鐯|䦃)
䦅	(鐥|䦅)
䦓	(覘|𦕒|䦓|觇)
䦘	(𨸄|䦘)
䦛	(䦶|䦛)
䦟	(䦷|䦟)
䦳	(𨷿|䦳)
䦶	(䦛|䦶)
䦷	(䦟|䦷)
䧢	(𨸟|䧢)
䨘	(霰|䨘)
䩞	(韂|䩞)
䪊	(龓|䪊)
䪏	(𩏼|䪏)
䪗	(𩐀|䪗)
䪘	(𩏿|䪘)
䪿	(囟|䪿|倖|幸|顖)
䫴	(𩖗|䫴)
䬒	(颼|䬒|飕)
䬘	(𩙮|䬘)
䬝	(𩙯|䬝)
䬞	(𩙧|䬞)
䬡	(翥|䬡)
䭀	(𩠇|䭀)
䭃	(𩠈|䭃)
䭪	(𩞯|䭪)
䭾	(馱|䭾|駄|驮)
䭿	(𩧭|䭿)
䮝	(𩧰|䮝)
䮞	(𩨁|䮞)
䮠	(𩧿|䮠)
䮫	(𩨇|䮫)
䮳	(𩨏|䮳)
䮾	(𩧪|䮾)
䯀	(䯅|䯀)
䯃	(𩣑|䯃)
䯄	(騧|䯄)
䯅	(䯀|䯅)
䯌	(尻|䯌)
䯻	(髻|䯻)
䰗	(鬮|䰗|阄)
䰾	(鲃|䰾)
䱇	(鱓|䱇|鱔|鳝)
䱙	(𩾈|䱙)
䱬	(𩾊|䱬)
䱰	(𩾋|䱰)
䱷	(䲣|漁|䱷|渔)
䱽	(䲝|鯧|䱽|鲳)
䲁	(鳚|䲁)
䲖	(𩾂|䲖)
䲝	(䱽|䲝|鯧|鲳)
䲞	(𩶘|䲞)
䲟	(鮣|䲟)
䲠	(鰆|䲠)
䲡	(鰌|䲡|魷|鰍|鱿|鳅)
䲢	(鰧|䲢)
䲣	(䱷|䲣|漁|渔)
䲤	(鿐|䲤)
䲰	(𪉂|䲰)
䴉	(鹮|䴉)
䴓	(鳾|䴓)
䴔	(鵁|䴔)
䴕	(鴷|䴕)
䴖	(鶄|䴖)
䴗	(鶪|䴗)
䴘	(鷈|䴘)
䴙	(鷿|䴙)
䴬	(𪎈|䴬)
䴴	(𪎋|䴴)
䴹	(餜|䴹|馃)
䵑	(䵒|䵑)
䵒	(䵑|䵒)
䶏	(涕|䶏|洟)
䶮	(龑|䶮)
一	(壹|弌|一|搋|扠)
七	(柒|七|漆|㯃|桼)
丄	(上|丄)
丅	(下|丅)
万	(卍|萬|万|卐)
三	(叁|三|參|叄|参|叅|蓡|薓|參)
上	(丄|上)
下	(丅|下)
丌	(其|丌|亓)
不	(不|不)
与	(與|与)
丐	(匃|丐|匄)
丑	(醜|丑)
专	(專|专|専|耑)
丕	(仳|丕)
世	(丗|卋|世)
丗	(世|丗|卋)
丘	(㐀|丠|坵|丘)
业	(業|业)
丛	(叢|丛|樷)
东	(東|东)
丝	(絲|丝|糸|纟|糹)
丟	(丢|丟)
丠	(丘|㐀|丠|坵)
両	(两|兩|両|兩)
丢	(丟|丢)
丣	(酉|丣|酋)
两	(両|兩|两|兩)
严	(嚴|严|厳)
並	(并|幷|竝|並|併|倂|𠊧)
丧	(喪|丧)
个	(個|箇|个)
丬	(爿|丬|𤕪)
中	(塚|中|冢|塚)
丰	(豐|丰|豊)
丱	(卝|丱)
串	(串|串)
临	(臨|临|臨)
丹	(丹|丹)
为	(為|为|爲)
丼	(井|丼)
丽	(麗|丽|麗)
举	(舉|㪯|举|挙|擧)
乃	(廼|迺|乃)
久	(乆|久)
乆	(久|乆)
乇	(虐|䖈|乇)
么	(幺|麼|麽|么|庅)
义	(義|义)
乌	(烏|乌)
乐	(樂|乐|楽|樂|樂|樂)
乔	(喬|乔)
乕	(虎|乕)
乗	(乘|乗)
乘	(乗|乘)
乚	(隱|乚|隐|隠)
九	(玖|九)
习	(習|习)
乡	(鄉|乡|郷|鄕)
书	(書|书)
乩	(稽|乩)
买	(買|买)
乱	(亂|乱|亂)
乾	(亁|干|榦|乾|幹)
亀	(龜|亀|龟|龜|龜)
亁	(乾|亁|干|榦|幹)
亂	(乱|亂|亂)
了	(瞭|了|了|暸)
予	(余|豫|予|餘|預|预|馀)
争	(爭|争)
亊	(事|亊)
事	(亊|事)
二	(弍|貮|貳|贰|二)
亍	(街|亍)
于	(扵|於|于|亏|虧)
亏	(扵|於|虧|于|亏)
云	(雲|云)
亓	(其|丌|亓)
五	(㐅|伍|五)
井	(丼|井)
亗	(岁|歲|𡻕|亗|嵗|歳)
亘	(亙|亘)
亙	(亘|亙)
亚	(亞|亚|亜)
亜	(亞|亚|亜)
亝	(齊|亝|斉|斋|齋|齐|斎)
亞	(亚|亜|亞)
亡	(亾|兦|亡)
产	(產|产|産)
亩	(畝|亩|畆|畒|畮)
享	(亯|享)
京	(亰|京)
亮	(亮|亮)
亯	(享|亯)
亰	(京|亰)
亱	(夜|亱)
亲	(榛|親|亲)
亵	(褻|䙝|亵|褺)
亷	(廉|亷|廉)
亸	(嚲|亸)
人	(亻|人)
亻	(人|亻)
亼	(集|亼)
亾	(亡|亾|兦)
亿	(億|亿)
什	(什|什|甚)
仁	(忈|仁)
仂	(働|仂)
仃	(停|仃)
仅	(僅|仅)
仆	(僕|仆)
仇	(讎|讐|雠|仇)
从	(從|从|従)
仏	(佛|仏)
仑	(侖|仑|崙|崘|崙)
仓	(倉|仓)
他	(她|牠|他|它|佗)
仙	(僊|仙)
仝	(同|仝|衕)
仞	(仭|仞)
仟	(千|阡|仟)
令	(令|令)
以	(㠯|以)
仪	(儀|仪)
们	(們|们)
仭	(仞|仭)
仮	(假|仮)
仳	(丕|仳)
价	(價|价|価)
任	(仼|任)
仼	(任|仼)
份	(分|彬|份|斌)
仾	(低|仾)
仿	(倣|彷|髣|仿|徬)
伀	(彸|伀)
伃	(妤|伃)
伍	(五|㐅|伍)
众	(眾|众|衆|𠂝)
优	(優|优)
伙	(夥|伙)
会	(會|会)
伛	(傴|伛)
伜	(倅|伜)
伝	(傳|伝|传)
伞	(傘|伞|繖)
伟	(偉|伟)
传	(傳|伝|传)
伡	(俥|伡)
伣	(俔|伣)
伤	(傷|伤)
伥	(倀|伥)
伦	(倫|伦|倫)
伧	(傖|伧)
伩	(信|伩)
伪	(偽|僞|伪)
伫	(佇|伫|竚)
伭	(玄|伭)
伱	(你|伱|伲|妳|您|祢|袮|奶|嬭|禰)
伲	(你|伱|伲|妳|您|祢|袮|奶|嬭|禰)
伷	(冑|胄|伷|咮)
伸	(抻|伸)
佇	(伫|竚|佇)
佈	(布|佈)
佋	(紹|佋|绍)
低	(仾|低)
佑	(祐|佑)
体	(軆|體|体|躰|骵)
佔	(占|佔)
佗	(它|佗|牠|他|她)
余	(予|余|餘|豫|馀|預|预)
佛	(仏|佛)
佞	(侫|佞)
你	(伱|伲|妳|您|祢|袮|你|奶|嬭|禰)
佣	(傭|佣)
佥	(僉|佥)
佬	(姆|佬|姥)
佰	(百|佰)
併	(倂|并|𠊧|併|並|幷|竝)
侁	(詵|駪|侁|诜)
侂	(託|侂|讬)
侄	(姪|侄)
侅	(賅|侅|赅)
來	(徠|来|耒|來|來|倈|勑|徕|俫|勅|敕)
侉	(誇|侉|夸)
例	(例|例)
侎	(敉|侎)
侖	(仑|崙|侖|崘|崙)
侚	(殉|狥|侚)
侠	(俠|侠)
価	(價|价|価)
侣	(侶|侣)
侥	(僥|侥|儌|徺)
侦	(偵|侦)
侧	(側|侧)
侨	(僑|侨)
侩	(儈|侩)
侪	(儕|侪)
侫	(佞|侫)
侬	(儂|侬)
侭	(儘|侭|尽|盡)
侮	(㑄|侮)
侶	(侣|侶)
便	(便|便)
俁	(俣|俁)
係	(系|係|繫|繋)
俈	(嚳|俈|喾)
俊	(儁|俊)
俎	(爼|俎)
俓	(勁|徑|俓|劲|径|迳|逕)
俔	(伣|俔)
俞	(兪|俞)
俟	(竢|俟)
俠	(侠|俠)
信	(伩|信)
俣	(俁|俣)
俥	(伡|俥)
俦	(儔|俦)
俨	(儼|俨)
俩	(倆|俩)
俪	(儷|俪)
俫	(倈|俫|勑|徠|勅|敕|來|徕|来|耒|來)
俭	(儉|俭|倹)
俯	(頫|俯)
俱	(倶|俱)
俲	(效|俲|効)
俻	(備|俻|偹|备)
倀	(伥|倀)
倂	(併|倂|并|𠊧|並|幷|竝)
倅	(伜|倅)
倆	(俩|倆)
倈	(俫|勑|徠|倈|勅|敕|來|徕|来|耒|來)
倉	(仓|倉)
個	(个|箇|個)
倏	(倐|倏)
倐	(倏|倐)
們	(们|們)
倖	(囟|幸|䪿|倖|顖)
倘	(儻|倘|傥)
借	(藉|借|耤)
倣	(仿|倣|彷|髣|徬)
値	(值|値)
倫	(伦|倫|倫)
倲	(㑈|倲)
倶	(俱|倶)
倹	(儉|俭|倹)
债	(債|债)
值	(値|值)
倾	(傾|倾)
偁	(稱|穪|偁|秤|称)
偃	(㫃|偃)
假	(仮|假)
偉	(伟|偉)
偊	(踽|偊)
偎	(渨|隈|偎)
偐	(贋|贗|偐|赝)
偑	(㐽|偑)
偒	(蕩|偒|盪|荡|蘯|逿|𨌩)
停	(仃|停)
健	(徤|健)
偪	(逼|偪)
偬	(傯|偬)
側	(侧|側)
偵	(侦|偵)
偷	(偸|偷)
偸	(偷|偸)
偹	(備|俻|偹|备)
偺	(咱|喒|昝|偺)
偻	(僂|偻)
偽	(伪|僞|偽)
偾	(僨|偾)
偿	(償|偿)
傁	(叜|叟|墰|傁|壜|罈|坛|壇)
傌	(罵|傌|駡|骂)
傍	(旁|傍)
傏	(搪|傏)
傑	(杰|傑)
傖	(伧|傖)
傘	(伞|繖|傘)
備	(俻|偹|备|備)
傜	(徭|傜)
傢	(家|傢)
傤	(儎|傤|載|载)
傥	(儻|倘|傥)
傧	(儐|傧)
储	(儲|储)
傩	(儺|傩)
傭	(佣|傭)
傯	(偬|傯)
傳	(伝|传|傳)
傴	(伛|傴)
債	(债|債)
傷	(伤|傷)
傻	(儍|傻)
傽	(慞|傽)
傾	(倾|傾)
僂	(偻|僂)
僅	(仅|僅)
僉	(佥|僉)
僊	(仙|僊)
働	(仂|働)
像	(象|像)
僑	(侨|僑)
僕	(仆|僕)
僚	(僚|僚)
僞	(伪|偽|僞)
僣	(僭|僣)
僥	(侥|儌|徺|僥)
僨	(偾|僨)
僭	(僣|僭)
僱	(雇|僱)
價	(价|価|價)
儀	(仪|儀)
儁	(俊|儁)
儂	(侬|儂)
億	(亿|億)
儆	(警|儆)
儈	(侩|儈)
儉	(俭|倹|儉)
儌	(僥|侥|儌|徺)
儍	(傻|儍)
儎	(傤|載|儎|载)
儐	(傧|儐)
儒	(㐵|儒)
儓	(枱|檯|儓|台|臺|颱)
儔	(俦|儔)
儕	(侪|儕)
儗	(擬|儗|拟)
儘	(侭|尽|儘|盡)
儛	(㒇|儛)
償	(偿|償)
儡	(酹|儡)
儣	(𠆲|儣)
優	(优|優)
儭	(襯|儭|衬)
儲	(储|儲)
儶	(㒞|儶)
儷	(俪|儷)
儸	(㑩|儸)
儺	(傩|儺)
儻	(倘|傥|儻)
儼	(俨|儼)
儿	(兒|儿|児)
兀	(兀|兀)
兇	(凶|㐫|兇)
光	(灮|光)
克	(剋|克|尅)
兌	(兑|兌)
兎	(兔|兎)
児	(兒|儿|児)
兑	(兌|兑)
兒	(儿|児|兒)
兔	(兎|兔)
兖	(兗|兖)
兗	(兖|兗)
党	(黨|党)
兦	(亡|亾|兦)
內	(内|內)
全	(㒰|全)
兩	(両|两|兩|兩)
兪	(俞|兪)
八	(捌|八)
六	(陸|六|六|陆|陸)
兮	(𠔃|兮)
兰	(蘭|兰|蘭)
关	(關|关|寡|関|闗|𨶹)
兴	(興|㒷|兴)
其	(丌|亓|其)
兹	(玆|茲|兹)
养	(養|养)
兽	(獸|兽|獣)
兿	(藝|兿|埶|秇|艺|芸|蓺|蕓)
冁	(囅|冁)
冂	(冋|坰|冂)
冄	(冉|冄)
内	(內|内)
円	(圓|円|圆|圎)
冈	(岡|冈|岗|崗)
冉	(冄|冉)
冊	(册|冊)
冋	(冂|坰|冋)
册	(冊|册)
冐	(冒|冐|冒)
冑	(伷|胄|冑|咮)
冒	(冐|冒|冒)
冗	(宂|冗|冗)
写	(寫|写|冩)
军	(軍|军)
农	(農|农|莀)
冝	(宜|冝|宐)
冢	(塚|中|冢|塚)
冤	(寃|冤)
冦	(寇|冦|宼)
冨	(富|冨)
冩	(寫|写|冩)
冪	(幂|羃|鼏|冪)
冫	(冰|氷|冫)
冬	(鼕|冬)
冯	(馮|冯)
冰	(冫|氷|冰)
冱	(沍|沪|冱|滬)
冲	(沖|衝|冲|盅|𧘂)
决	(決|决)
况	(況|况|湟)
冷	(冷|冷)
冻	(凍|冻)
冽	(洌|冽)
净	(凈|淨|净|浄)
凂	(浼|凂|潣)
凃	(塗|凃|涂)
凄	(淒|凄|悽)
凅	(涸|凅)
准	(準|准|凖)
凈	(净|淨|凈|浄)
凉	(涼|凉|鿌|凉)
凋	(雕|㓮|凋|彫|琱|鵰)
凌	(凌|凌)
凍	(冻|凍)
减	(減|减)
凑	(湊|凑)
凖	(準|准|凖)
凙	(𪞝|凙)
凛	(凜|懔|凛|凜|懍)
凜	(凛|凜|凜|懔|懍)
凞	(凞|凞)
几	(幾|几)
凡	(凢|凣|凡)
凢	(凡|凢|凣)
凣	(凡|凢|凣)
凤	(鳳|凤|鳯)
処	(䖏|處|処|嗻|处)
凨	(風|凨|风)
凫	(鳧|凫)
凭	(憑|凭|凴|𠗦)
凯	(凱|凯)
凱	(凯|凱)
凳	(櫈|凳)
凴	(憑|凭|凴|𠗦)
凶	(㐫|兇|凶)
凷	(塊|凷|块)
凹	(𠕄|凹)
出	(岀|出)
击	(擊|击|撃)
凼	(幽|凼)
函	(凾|圅|函)
凾	(函|圅|凾)
凿	(鑿|凿)
刀	(刂|刀)
刂	(刀|刂)
刃	(刄|刃)
刄	(刃|刄)
刅	(創|刅|创|刱|剙|戧|剏|戗)
分	(份|分|彬|斌)
切	(切|切)
刈	(苅|刈)
刊	(刋|刊)
刋	(刊|刋)
刍	(芻|刍|蒭|𦷝)
划	(劃|划)
刓	(园|刓|園)
刔	(抉|刔)
列	(列|列)
刘	(劉|刘|劉)
则	(則|则)
刚	(剛|刚)
创	(創|刅|创|刱|剙|戧|剏|戗)
删	(刪|删)
別	(别|別)
刦	(刧|劫|刦|刼)
刧	(刦|劫|刧|刼)
刨	(鉋|刨|铇)
利	(利|𥝢|利)
刪	(删|刪)
别	(別|别)
刬	(剗|刬|剷|鏟|铲)
刭	(剄|刭)
刮	(颳|刮)
刱	(剏|創|刱|刅|创|剙|戧|戗)
刴	(剁|刴)
制	(製|制)
刷	(㕞|刷)
券	(劵|券)
刹	(剎|刹)
刺	(刾|莿|刺|㓨|刺|朿)
刼	(劫|刦|刧|刼)
刽	(劊|刽)
刾	(㓨|刺|刾|莿|刺|朿)
刿	(劌|刿)
剀	(剴|剀)
剁	(刴|剁)
剂	(劑|剂|剤)
剃	(鬀|剃)
剄	(刭|剄)
則	(则|則)
剉	(銼|剉|锉)
剋	(克|尅|剋)
剌	(巤|剌|鬣)
剎	(刹|剎)
剏	(刱|剏|創|刅|创|剙|戧|戗)
剐	(剮|剐)
剑	(劍|剑|剣|剱|劒|劔|釖|釼|劎)
剗	(刬|剷|鏟|剗|铲)
剙	(創|刅|创|刱|剙|戧|剏|戗)
剛	(刚|剛)
剝	(剥|剝)
剣	(劍|剑|剣|剱|劒|劔|釖|釼|劎)
剤	(劑|剂|剤)
剥	(剝|剥)
剦	(閹|剦|阉)
剧	(劇|剧)
剩	(剰|賸|剩)
剪	(翦|剪)
剮	(剐|剮)
剰	(剩|剰|賸)
剱	(劍|剑|剣|剱|劒|劔|釖|釼|劎)
剳	(劄|箚|剳|札)
剴	(剀|剴)
創	(刅|创|刱|剙|戧|創|剏|戗)
剷	(剗|鏟|刬|剷|铲)
剾	(𠛅|剾)
剿	(勦|𠞰|剿)
劃	(划|劃)
劄	(剳|劄|箚|札)
劆	(鐮|劆|鎌|镰)
劇	(剧|劇)
劈	(擗|劈)
劉	(刘|劉|劉)
劊	(刽|劊)
劌	(刿|劌)
劍	(剑|剣|剱|劒|劔|釖|釼|劍|劎)
劎	(劔|劍|劎|剑|剣|剱|劒|釖|釼)
劏	(㓥|劏)
劑	(剂|剤|劑)
劒	(劍|剑|剣|剱|劒|劔|釖|釼|劎)
劓	(㓷|劓)
劔	(劍|劎|剑|剣|剱|劒|劔|釖|釼)
劚	(㔉|劚)
力	(力|力)
劝	(勸|劝|勧)
办	(辦|办)
务	(務|务)
劢	(勱|勵|劢|励|勵)
劣	(劣|劣)
动	(動|动)
劫	(刦|刧|刼|劫)
励	(勵|劢|励|勵|勱)
劲	(勁|俓|劲|徑|径|迳|逕)
劳	(勞|劳|労|勞)
労	(勞|劳|労|勞)
劵	(券|劵)
効	(效|俲|効)
势	(勢|势)
勁	(俓|劲|徑|勁|径|迳|逕)
勃	(艴|勃)
勄	(敏|勄)
勅	(勑|敕|倈|勅|徠|俫|來|徕|来|耒|來)
勋	(勛|勋|勲|勳)
勑	(倈|勅|徠|敕|俫|勑|來|徕|来|耒|來)
勒	(勒|勒)
動	(动|動)
勖	(勗|勖|朂)
勗	(勖|朂|勗)
務	(务|務)
勚	(勩|勚)
勛	(勋|勲|勳|勛)
勝	(胜|勝)
勞	(劳|労|勞|勞)
勢	(势|勢)
勤	(懃|勤)
勦	(剿|勦|𠞰)
勧	(勸|劝|勧)
勩	(勚|勩)
勰	(協|恊|脅|勰|协|旪|胁|脇)
勱	(劢|勱|勵|励|勵)
勲	(勛|勋|勲|勳)
勳	(勛|勋|勲|勳)
勵	(劢|励|勵|勱|勵)
勸	(劝|勧|勸)
勹	(包|勹)
勻	(匀|勻)
勽	(㲒|菢|勽)
勾	(句|勾|句)
匀	(勻|匀)
匃	(丐|匄|匃)
匄	(匃|丐|匄)
包	(勹|包)
匆	(怱|悤|匆)
匈	(胷|胸|匈)
匊	(掬|匊)
匋	(陶|匋)
匏	(瓟|匏)
北	(北|北)
匘	(腦|匘|脑|脳)
匙	(鍉|匙)
匝	(帀|迊|匝)
匦	(匭|匦)
匧	(篋|匧|箧)
匭	(匦|匭)
匮	(匱|匮|樻|櫃|鐀|饋|柜|餽|馈)
匯	(汇|滙|匯|彙|彚)
匱	(匮|樻|櫃|鐀|饋|匱|柜|餽|馈)
匳	(奩|匳|奁)
匵	(櫝|匵|椟)
匹	(疋|匹)
区	(區|区)
医	(醫|医)
匿	(匿|匿)
區	(区|區)
十	(拾|拾|十)
千	(仟|千|阡)
卄	(廿|卄|廾)
卆	(卒|䘚|卆)
升	(昇|陞|升)
卉	(芔|卉)
卋	(世|丗|卋)
卌	(𠦌|𠦜|卌)
卍	(万|卐|萬|卍)
华	(華|华|崋|蕐)
协	(協|勰|协|恊|旪|脅|胁|脇)
卐	(卍|万|卐|萬)
卒	(䘚|卆|卒)
卓	(棹|卓|掉|桌|櫂)
協	(勰|协|恊|旪|協|脅|胁|脇)
单	(單|单|単)
卖	(賣|卖|売)
単	(單|单|単)
博	(愽|博)
卝	(丱|卝)
占	(佔|占)
卢	(盧|卢|盧)
卤	(鹵|卤)
卧	(臥|卧)
卩	(㔾|節|部|卩|罇|节|墫|樽)
卫	(衛|卫|衞)
卬	(卭|卬)
卭	(卬|卭)
卮	(巵|卮)
卯	(夘|戼|卯)
即	(卽|即)
却	(卻|却)
卵	(卵|卵)
卷	(捲|卷|巻)
卸	(缷|卸)
卹	(恤|卹|賉)
卻	(却|卻)
卽	(即|卽)
厂	(廠|厂|厰)
厄	(戹|阨|厄|呃|阸)
厅	(廳|厅|厛|庁|廰)
历	(厲|曆|歷|历|厉|厤|暦|歴|曆|歷)
厉	(厲|历|厉|曆|歷|厤|暦|歴|曆|歷)
压	(壓|压|圧)
厌	(厭|厌)
厍	(厙|厍)
厎	(砥|厎)
厐	(龎|龐|厐|厖|庞|庬)
厓	(崖|厓|崕)
厕	(廁|厕|厠)
厖	(庬|龐|厖|厐|庞|龎)
厘	(釐|𭀖|厘)
厙	(厍|厙)
厛	(廳|厅|厛|庁|廰)
厠	(廁|厕|厠)
厢	(廂|厢)
厣	(厴|厣)
厤	(曆|历|厤|暦|歴|歷|曆|厲|歷|厉)
厦	(廈|厦)
厨	(㕑|廚|𢊍|厨)
厩	(廄|廐|厩|廏)
厪	(廑|厪)
厭	(厌|厭)
厮	(㒋|廝|厮)
厰	(廠|厂|厰)
厲	(历|厉|厲|曆|歷|厤|暦|歴|曆|歷)
厳	(嚴|严|厳)
厴	(厣|厴)
厵	(源|厵|沅)
厶	(某|私|厶)
厷	(肱|厷)
厹	(叴|厹)
县	(縣|县)
叁	(三|參|叄|叁|参|叅|蓡|薓|參)
参	(參|叁|参|叄|叅|蓡|薓|參|三)
參	(叁|参|叄|叅|蓡|薓|參|三|參)
叄	(叁|參|三|叄|参|叅|蓡|薓|參)
叅	(參|叁|参|叄|叅|蓡|薓|參|三)
叆	(靉|叆)
叇	(靆|叇)
叉	(釵|叉|钗)
双	(雙|双)
収	(收|㧃|収)
发	(發|髮|发|彂|発|髪)
叔	(尗|叔)
变	(變|变|変)
叙	(敍|敘|叙)
叜	(傁|叟|叜|墰|壜|罈|坛|壇)
叝	(告|叝|吿)
叟	(傁|叜|墰|叟|壜|罈|坛|壇)
叠	(曡|疊|叠|疉|畳|迭)
叡	(睿|叡)
叢	(丛|樷|叢)
句	(勾|句|句)
叨	(饕|叨)
只	(子|止|祇|祗|隻|只)
叫	(呌|叫)
台	(台|檯|臺|颱|儓|枱)
叴	(厹|叴)
叵	(尀|叵)
叶	(葉|叶|葉)
号	(號|号)
叹	(嘆|叹|歎)
叽	(嘰|叽)
吁	(籲|吁|龥)
吃	(喫|吃)
吅	(喧|吅|諠)
合	(閤|合|闔|阖)
吊	(弔|吊)
吋	(寸|吋)
同	(仝|同|衕)
后	(后|後)
吏	(吏|吏)
向	(嚮|曏|向)
吒	(咤|吒)
吓	(嚇|吓)
吕	(呂|吕|呂)
吗	(嗎|吗)
吚	(咿|吚)
吝	(恡|悋|吝|吝)
吞	(呑|吞)
吟	(唫|吟)
吣	(唚|吣)
吨	(啍|噸|吨)
含	(唅|含)
听	(聽|听|聴|聼)
启	(啓|啟|启|啔)
吲	(哂|吲)
吳	(吴|呉|吳)
吴	(吳|吴|呉)
吶	(呐|訥|吶|讷)
吸	(噏|吸)
吹	(龡|吹)
吻	(呡|肳|吻)
吿	(告|叝|吿)
呂	(吕|呂|呂)
呃	(阨|厄|呃|阸|戹)
呆	(獃|騃|呆|𫘤)
呉	(吳|吴|呉)
告	(叝|吿|告)
呌	(叫|呌)
呐	(吶|呐|訥|讷)
呑	(吞|呑)
呒	(嘸|呒)
呓	(囈|呓)
呕	(嘔|呕|慪|怄)
呖	(嚦|呖)
呗	(唄|呗)
员	(員|员)
呙	(咼|呙)
呛	(嗆|呛)
呜	(嗚|呜)
呠	(噴|歕|呠|喷)
呡	(吻|呡|肳)
周	(週|周)
呪	(咒|詋|呪)
呱	(哌|呱)
呴	(詬|呴|訽|诟)
呵	(嗬|訶|诃|呵)
呼	(嘑|虖|謼|呼)
咀	(嘴|觜|咀)
咂	(𠯗|咂)
咊	(和|龢|咊)
和	(咊|龢|和)
咏	(詠|咏)
咒	(呪|咒|詋)
咙	(嚨|咙)
咛	(嚀|咛)
咝	(噝|咝)
咤	(吒|咤)
咥	(嘻|咥)
咨	(嗞|諮|谘|咨)
咩	(哶|咩)
咬	(齩|咬)
咮	(胄|伷|冑|咮)
咯	(詻|咯)
咱	(偺|喒|咱|昝)
咲	(笑|咲)
咳	(欬|咳)
咷	(啕|咷)
咸	(鹹|咸)
咼	(呙|咼)
咽	(嚥|咽|咽)
咿	(吚|咿)
哂	(吲|哂)
哄	(閧|鬨|哄)
哌	(呱|哌)
响	(響|响)
哑	(啞|哑|唖|瘂|痖)
哒	(噠|哒)
哓	(嘵|哓)
哔	(嗶|哔)
哕	(噦|哕|𧬨)
哗	(嘩|譁|哗)
哙	(噲|哙)
哜	(嚌|哜)
哝	(噥|哝)
哟	(喲|哟)
員	(员|員)
哦	(誐|哦)
哯	(𠯟|哯)
哲	(喆|悊|哲)
哴	(喨|哴)
哶	(咩|哶)
哼	(苛|哼)
唁	(喭|唁)
唄	(呗|唄)
唅	(含|唅)
唇	(脣|唇)
唉	(欸|誒|诶|唉)
唊	(硤|唊|硖)
唖	(啞|哑|唖|瘂|痖)
唚	(吣|唚)
唛	(嘜|唛)
唝	(嗊|唝)
唠	(嘮|唠)
唡	(啢|唡)
唢	(嗩|唢)
唤	(喚|唤)
唧	(喞|唧)
唫	(吟|唫)
唬	(猇|虓|諕|唬)
唷	(唹|唷)
唹	(唷|唹)
唾	(涶|唾)
啃	(齦|啃|龈)
啊	(阿|啊|窕)
啍	(吨|啍|噸)
啎	(忤|啎|迕)
問	(问|問)
啓	(启|啔|啟|啓)
啔	(啓|启|啔|啟)
啕	(咷|啕)
啖	(㗖|啗|噉|啖)
啗	(㗖|啖|噉|啗)
啜	(欼|歠|諁|啜)
啞	(哑|唖|瘂|啞|痖)
啟	(启|啓|啟|啔)
啢	(唡|啢)
啣	(㘅|啣|銜|衔)
啧	(嘖|啧)
啬	(嗇|啬)
啭	(囀|啭)
啮	(嚙|啮|囓|齧)
啯	(嘓|啯)
啰	(囉|啰|罗|羅|羅)
啴	(嘽|啴)
啸	(嘯|啸|嘨|歗)
啼	(嗁|啼)
喂	(餧|餵|喂|餒|諉|诿|馁)
喃	(娚|嫐|諵|喃)
善	(譱|善)
喆	(哲|喆|悊)
喇	(喇|喇)
喎	(㖞|喎)
喐	(郁|喐|鬱|欝|鬰)
喒	(偺|咱|昝|喒)
喚	(唤|喚)
喜	(憙|喜)
喞	(唧|喞)
喧	(吅|諠|喧)
喨	(哴|喨)
喩	(喻|喩)
喪	(丧|喪)
喫	(吃|喫)
喬	(乔|喬)
喭	(唁|喭)
單	(单|単|單)
喰	(餐|喰|飡)
喲	(哟|喲)
営	(營|営|营)
喷	(噴|呠|喷|歕)
喻	(喩|喻)
喽	(嘍|喽|謱)
喾	(嚳|俈|喾)
喿	(噪|喿|譟)
嗀	(嗀|嗀)
嗁	(啼|嗁)
嗅	(齅|嗅)
嗆	(呛|嗆)
嗇	(啬|嗇)
嗉	(膆|嗉)
嗊	(唝|嗊)
嗎	(吗|嗎)
嗒	(㗳|嗒)
嗚	(呜|嗚)
嗞	(咨|諮|嗞|谘)
嗥	(嘷|嚎|嗥|噑)
嗩	(唢|嗩)
嗫	(囁|嗫|讘)
嗬	(呵|嗬|訶|诃)
嗳	(噯|嗳)
嗶	(哔|嗶)
嗹	(𪡏|嗹)
嗻	(處|䖏|処|嗻|处)
嗽	(瘶|嗽)
嘆	(叹|歎|嘆)
嘈	(䜊|嘈)
嘍	(喽|謱|嘍)
嘎	(尜|嘎)
嘑	(呼|嘑|虖|謼)
嘓	(啯|嘓)
嘔	(呕|慪|嘔|怄)
嘖	(啧|嘖)
嘗	(尝|甞|嘗)
嘘	(噓|嘘)
嘜	(唛|嘜)
嘤	(嚶|嘤)
嘨	(嘯|啸|嘨|歗)
嘩	(哗|譁|嘩)
嘮	(唠|嘮)
嘯	(啸|嘨|歗|嘯)
嘰	(叽|嘰)
嘱	(囑|嘱)
嘴	(咀|觜|嘴)
嘵	(哓|嘵)
嘷	(嗥|嘷|嚎|噑)
嘸	(呒|嘸)
嘻	(咥|嘻)
嘽	(啴|嘽)
嘿	(默|嘿|黙)
噁	(恶|噁|惡|悪|惡)
噂	(譐|噂)
噅	(噕|𠯠|噅)
噉	(㗖|啖|啗|噉)
噏	(吸|噏)
噐	(器|噐)
噑	(嚎|嗥|噑|嘷)
噓	(嘘|噓)
噕	(噅|噕|𠯠)
噚	(㖊|噚)
噜	(嚕|噜)
噝	(咝|噝)
噠	(哒|噠)
噥	(哝|噥)
噦	(哕|𧬨|噦)
器	(噐|器)
噪	(喿|譟|噪)
噯	(嗳|噯)
噲	(哙|噲)
噴	(呠|喷|歕|噴)
噸	(吨|啍|噸)
噹	(当|噹|當)
嚀	(咛|嚀)
嚇	(吓|嚇)
嚌	(哜|嚌)
嚎	(嗥|噑|嘷|嚎)
嚏	(嚔|嚏)
嚔	(嚏|嚔)
嚕	(噜|嚕)
嚙	(啮|囓|齧|嚙)
嚠	(瀏|嚠|浏)
嚢	(囊|嚢)
嚣	(囂|嚣|嚻)
嚥	(咽|咽|嚥)
嚦	(呖|嚦)
嚨	(咙|嚨)
嚬	(顰|嚬|颦)
嚮	(向|嚮|曏)
嚲	(亸|嚲)
嚳	(俈|喾|嚳)
嚴	(严|厳|嚴)
嚵	(饞|嚵|馋)
嚶	(嘤|嚶)
嚹	(𡅈|嚹)
嚻	(囂|嚣|嚻)
囀	(啭|囀)
囁	(嗫|讘|囁)
囂	(嚣|嚻|囂)
囅	(冁|囅)
囈	(呓|囈)
囉	(啰|罗|囉|羅|羅)
囊	(嚢|囊)
囌	(蘇|囌|苏|蘓)
囑	(嘱|囑)
囓	(嚙|齧|啮|囓)
囘	(回|囬|囘|廻|廽|迴|逥)
四	(肆|四)
回	(囘|囬|廻|廽|迴|逥|回)
囟	(䪿|倖|幸|顖|囟)
团	(團|团|団)
団	(團|团|団)
囤	(𥫱|囤)
囪	(囱|囪)
囬	(囘|回|囬|廻|廽|迴|逥)
园	(刓|園|园)
囮	(諤|𡈙|囮|讍|谔)
囯	(國|囯|国|圀)
困	(睏|困)
囱	(囪|囱)
囲	(圍|囲|围)
図	(圖|図|图|圕)
围	(圍|囲|围)
囵	(圇|囵)
囹	(囹|囹)
国	(國|囯|国|圀)
图	(圖|図|图|圕)
圀	(國|囯|国|圀)
圅	(函|凾|圅)
圆	(圓|円|圆|圎)
圇	(囵|圇)
圈	(圏|圈)
國	(囯|国|圀|國)
圍	(囲|围|圍)
圎	(圓|円|圆|圎)
圏	(圈|圏)
園	(园|刓|園)
圓	(円|圆|圎|圓)
圕	(圖|図|图|圕)
圖	(図|图|圕|圖)
團	(团|団|團)
圝	(圞|圝|𪢮)
圞	(圝|𪢮|圞)
圢	(町|圢)
圣	(聖|圣|垩|堊)
圧	(壓|压|圧)
圬	(杇|圬)
圭	(珪|圭)
圹	(壙|圹)
场	(場|场|塲)
圻	(垠|圻)
址	(阯|址)
坂	(阪|坂)
坆	(墳|坆|坟)
坋	(坌|坋)
坌	(坋|坌)
坎	(埳|坎)
坏	(坯|壞|坏|壊)
坐	(座|坐)
坑	(阬|坑)
块	(塊|凷|块)
坚	(堅|坚)
坛	(壇|罈|坛|墰|壜|傁|叟|叜)
坜	(壢|坜)
坝	(壩|坝|垻)
坞	(塢|坞|鄔|隖|隝|邬)
坟	(墳|坆|坟)
坠	(墜|坠)
坤	(堃|坤)
坫	(店|坫)
坭	(泥|坭|泥)
坯	(坏|壞|坯|壊)
坰	(冂|冋|坰)
坵	(丘|㐀|丠|坵)
垂	(埀|垂)
垄	(壟|垄|壟)
垅	(壠|垅)
垆	(壚|垆)
垒	(壘|垒|塁|壘)
垓	(陔|垓)
垔	(堙|陻|垔)
垛	(垜|垛)
垜	(垛|垜)
垠	(圻|垠)
垦	(墾|垦)
垩	(堊|聖|垩|圣)
垫	(墊|垫)
垭	(埡|垭)
垱	(壋|垱)
垲	(塏|垲)
垴	(堖|垴)
垵	(埯|垵)
垻	(壩|坝|垻)
埀	(垂|埀)
埇	(甬|埇)
埒	(埓|埒)
埓	(埒|埓)
埘	(塒|埘)
埙	(塤|埙|壎)
埚	(堝|埚)
埜	(野|埜)
域	(㽣|譽|域|誉)
埡	(垭|埡)
埯	(垵|埯)
埰	(采|埰|採|釆)
埳	(坎|埳)
埶	(秇|蓺|藝|埶|兿|艺|芸|蕓)
執	(执|執)
基	(抍|拯|基)
埼	(崎|埼|嵜|碕)
埽	(掃|埽|扫)
堃	(坤|堃)
堅	(坚|堅)
堆	(𠂤|堆|𣳨)
堇	(菫|堇)
堈	(缸|罁|堈)
堊	(垩|聖|堊|圣)
堑	(塹|堑|壍)
堕	(墮|堕)
堖	(垴|堖)
堘	(塍|堘)
堙	(垔|陻|堙)
堝	(埚|堝)
堤	(隄|堤)
堦	(階|堦|阶)
堭	(隍|堭)
堯	(尧|尭|堯)
報	(报|報)
場	(场|塲|場)
堺	(界|堺|畍)
堿	(鹻|鹼|堿|碱|硷|鹸|礆|險|险|険)
塁	(壘|垒|塁|壘)
塆	(壪|塆)
塈	(墍|塈)
塊	(凷|块|塊)
塋	(茔|塋)
塍	(堘|塍)
塏	(垲|塏)
塐	(塑|塐)
塑	(塐|塑)
塒	(埘|塒)
塔	(㙮|墖|塔)
塗	(凃|涂|塗)
塚	(中|冢|塚|塚)
塜	(塳|塜)
塞	(塞|塞)
塟	(葬|塟)
塡	(填|窴|塡)
塢	(坞|鄔|隖|隝|塢|邬)
塤	(埙|壎|塤)
塩	(鹽|䀋|塩|盐|𥂁)
填	(塡|填|窴)
塲	(場|场|塲)
塳	(塜|塳)
塵	(尘|塵)
塹	(堑|壍|塹)
塾	(孰|塾)
墈	(磡|墈)
墊	(垫|墊)
墍	(塈|墍)
墖	(塔|㙮|墖)
増	(增|増)
墙	(牆|墙|墻|廧)
墜	(坠|墜)
墝	(磽|墝|硗)
增	(増|增)
墤	(隤|墤|𬯎)
墫	(樽|罇|墫|節|卩|节|㔾|部)
墮	(堕|墮)
墰	(傁|叟|壜|罈|叜|墰|坛|壇)
墳	(坆|坟|墳)
墻	(廧|牆|墻|墙)
墾	(垦|墾)
壇	(坛|壇|罈|墰|壜|傁|叟|叜)
壈	(𡒄|壈)
壊	(壞|坏|坯|壊)
壋	(垱|壋)
壌	(壤|壌)
壍	(塹|堑|壍)
壎	(塤|埙|壎)
壐	(璽|壐|玺)
壓	(压|圧|壓)
壘	(垒|塁|壘|壘)
壙	(圹|壙)
壚	(垆|壚)
壜	(墰|罈|傁|叟|壜|坛|叜|壇)
壞	(坏|坯|壊|壞)
壟	(垄|壟|壟)
壠	(垅|壠)
壢	(坜|壢)
壤	(壌|壤)
壩	(坝|垻|壩)
壪	(塆|壪)
壮	(壯|壮)
壯	(壮|壯)
声	(聲|声)
売	(賣|卖|売)
壳	(㱿|殻|殼|壳)
壶	(壺|壶|壷)
壷	(壺|壶|壷)
壸	(壼|壸)
壹	(一|弌|搋|壹|扠)
壺	(壶|壷|壺)
壻	(婿|壻|聟)
壼	(壸|壼)
壽	(夀|寿|壽)
夀	(壽|寿|夀)
处	(處|䖏|処|嗻|处)
夅	(降|夅|降)
备	(備|俻|偹|备)
変	(變|变|変)
夊	(攵|夊|攴|撲|扑)
复	(復|複|覆|复|復)
夐	(敻|夐)
外	(舀|外|抌)
夘	(卯|夘|戼)
多	(夛|多)
夛	(多|夛)
夜	(亱|夜)
够	(夠|彀|够)
夠	(够|彀|夠)
夢	(夣|梦|夢)
夣	(夢|夣|梦)
夥	(伙|夥)
天	(靝|天|靔)
夭	(殀|夭)
夯	(䂫|夯)
夲	(本|夲)
头	(頭|头)
夸	(誇|侉|夸)
夹	(夾|夹)
夺	(奪|夺)
夾	(夹|夾)
奁	(奩|匳|奁)
奂	(奐|奂)
奇	(竒|奇)
奈	(柰|奈|奈)
奋	(奮|奋)
奌	(點|奌|点)
奎	(㚝|奞|奎)
奐	(奂|奐)
契	(契|契)
奔	(犇|逩|奔)
奕	(弈|奕)
奖	(奬|獎|奖|奨)
奘	(弉|奘)
奞	(㚝|奎|奞)
奥	(奧|奥)
奧	(奥|奧)
奨	(奬|奖|奨|獎)
奩	(匳|奁|奩)
奪	(夺|奪)
奬	(奖|奨|獎|奬)
奮	(奋|奮)
女	(女|女)
奶	(妳|嬭|你|奶|您|祢|袮|伱|伲|禰)
奸	(姦|奸)
她	(他|她|牠|它|佗)
奼	(姹|奼)
妆	(妝|妆|粧)
妇	(婦|妇|媍)
妈	(媽|妈)
妊	(姙|妊)
妍	(姸|妍)
妒	(妬|妒)
妙	(玅|妙)
妝	(妆|粧|妝)
妤	(伃|妤)
妩	(嫵|妩|娬)
妪	(嫗|妪)
妫	(媯|妫|嬀)
妬	(妒|妬)
妳	(你|奶|嬭|您|祢|袮|伱|伲|妳|禰)
姆	(佬|姥|姆)
姉	(姊|姉)
姊	(姉|姊)
姍	(姗|姍)
姗	(姍|姗)
姙	(妊|姙)
姜	(薑|姜|葁)
姢	(娟|姢)
姣	(㚣|姣)
姥	(姆|佬|姥)
姦	(奸|姦)
姪	(侄|姪)
姫	(姬|姫)
姬	(姫|姬)
姸	(妍|姸)
姹	(奼|姹)
姻	(婣|姻)
娄	(婁|娄)
娅	(婭|娅)
娆	(嬈|娆)
娇	(嬌|娇|撟|挢)
娈	(孌|娈)
娘	(嬢|孃|娘)
娚	(喃|娚|嫐|諵)
娛	(娯|娱|娛)
娟	(姢|娟)
娠	(㛛|暖|煖|娠|諼|谖)
娩	(㝃|娩)
娬	(嫵|妩|娬)
娯	(娛|娯|娱)
娱	(娛|娯|娱)
娲	(媧|娲)
娴	(嫻|娴|嫺)
娿	(婀|娿)
婀	(娿|婀)
婁	(娄|婁)
婣	(姻|婣)
婦	(妇|媍|婦)
婬	(淫|婬)
婭	(娅|婭)
婳	(嫿|婳)
婴	(嬰|婴|孾)
婵	(嬋|婵)
婶	(嬸|婶)
婾	(媮|婾)
婿	(壻|聟|婿)
媆	(嫩|嫰|媆|𡞾)
媍	(婦|妇|媍)
媧	(娲|媧)
媪	(媼|媪)
媭	(嬃|媭)
媮	(婾|媮)
媯	(妫|嬀|媯)
媰	(㛀|媰)
媼	(媪|媼)
媽	(妈|媽)
媿	(愧|媿)
嫉	(𡜱|嫉)
嫋	(嬝|嫋|袅|裊)
嫐	(喃|娚|嫐|諵)
嫒	(嬡|嫒)
嫔	(嬪|嫔)
嫕	(嫛|嫕)
嫗	(妪|嫗)
嫛	(嫕|嫛)
嫩	(媆|嫰|𡞾|嫩)
嫫	(嬷|嫫|嬤)
嫰	(媆|嫩|𡞾|嫰)
嫱	(嬙|嫱)
嫵	(妩|娬|嫵)
嫺	(嫻|娴|嫺)
嫻	(娴|嫺|嫻)
嫿	(婳|嫿)
嬀	(媯|妫|嬀)
嬃	(媭|嬃)
嬈	(娆|嬈)
嬋	(婵|嬋)
嬌	(娇|撟|嬌|挢)
嬙	(嫱|嬙)
嬝	(嫋|袅|裊|嬝)
嬡	(嫒|嬡)
嬢	(娘|嬢|孃)
嬤	(嬷|嫫|嬤)
嬪	(嫔|嬪)
嬭	(奶|妳|嬭|你|您|祢|袮|伱|伲|禰)
嬰	(婴|孾|嬰)
嬲	(惱|嬲|恼)
嬷	(嫫|嬤|嬷)
嬸	(婶|嬸)
嬾	(懶|嬾|懒|懶)
孀	(霜|孀)
孃	(娘|嬢|孃)
孋	(㛤|孋)
孌	(娈|孌)
子	(只|子|止|祇|祗|隻)
孙	(孫|孙)
孚	(孵|孚)
孛	(柏|栢|孛)
学	(學|学|斈)
孪	(孿|孪)
孫	(孙|孫)
孭	(𧴯|孭)
孰	(塾|孰)
孳	(孶|孳)
孵	(孚|孵)
孶	(孳|孶)
學	(学|斈|學)
孼	(孽|孼)
孽	(孼|孽)
孾	(嬰|婴|孾)
孿	(孪|孿)
宁	(寧|宁|寍|寕|寜|寧|寧|𡨴)
宂	(冗|宂|冗)
它	(佗|牠|它|他|她)
宅	(宅|宅)
完	(烟|煙|完|菸)
宍	(肉|宍)
宐	(宜|冝|宐)
宜	(冝|宐|宜)
宝	(寚|寳|寶|宝)
实	(實|实|実|寔)
実	(實|实|実|寔)
宠	(寵|宠|𠖥)
审	(審|审)
宪	(憲|宪)
宫	(宮|宫)
宮	(宫|宮)
宴	(讌|䜩|宴|燕|醼|鷰)
家	(傢|家)
宻	(密|宻)
宼	(寇|冦|宼)
宽	(寬|宽|寛)
宾	(賓|宾|賔)
宿	(㝛|宿)
寃	(冤|寃)
密	(宻|密)
寇	(冦|宼|寇)
富	(冨|富)
寍	(寧|宁|寍|寕|寜|寧|寧|𡨴)
寓	(庽|寓)
寔	(實|实|実|寔)
寕	(寜|寧|寕|宁|寍|寧|寧|𡨴)
寗	(甯|寗)
寘	(置|寘)
寚	(宝|寳|寚|寶)
寛	(寬|宽|寛)
寜	(寕|寧|寜|宁|寍|寧|寧|𡨴)
寝	(寢|寝)
察	(詧|察)
寠	(窶|寠|窭)
寡	(關|关|寡|関|闗|𨶹)
寢	(寝|寢)
實	(实|実|寔|實)
寧	(宁|寍|寕|寜|寧|寧|𡨴|寧)
寨	(砦|寨)
審	(审|審)
寫	(写|冩|寫)
寬	(宽|寛|寬)
寮	(寮|寮)
寳	(宝|寚|寶|寳)
寵	(宠|𠖥|寵)
寶	(宝|寳|寚|寶)
寸	(吋|寸)
对	(對|对)
寻	(尋|寻)
导	(導|导)
寿	(壽|夀|寿)
尀	(叵|尀)
専	(專|专|専|耑)
尃	(敷|旉|尃)
尅	(剋|克|尅)
将	(將|𤕭|将|畺|疆)
將	(将|畺|疆|𤕭|將)
專	(专|専|耑|專)
尉	(熨|㷉|尉)
尋	(寻|尋)
對	(对|對)
導	(导|導)
尒	(尔|爾|尒|尓)
尓	(爾|尒|尓|尔)
尔	(尒|爾|尔|尓)
尗	(叔|尗)
尘	(塵|尘)
尙	(尚|尙)
尚	(尙|尚)
尜	(嘎|尜)
尝	(嘗|尝|甞)
尟	(鮮|尟|尠|鱻|鲜)
尠	(鮮|尟|尠|鱻|鲜)
尢	(尣|尢)
尣	(尢|尣)
尥	(尦|尥)
尦	(尥|尦)
尧	(堯|尧|尭)
尨	(狵|龍|尨|竜|龒|龙|龍)
尩	(㑌|尩)
尪	(尫|尪)
尫	(尪|尫)
尭	(堯|尧|尭)
尰	(腫|尰|肿)
尲	(尷|尲|尴)
尴	(尷|尲|尴)
尷	(尲|尴|尷)
尸	(屍|尸)
尻	(䯌|尻)
尽	(儘|盡|侭|尽)
尿	(氽|溺|脲|尿|尿|氼|溺)
层	(層|层)
屃	(屓|屃|屭)
居	(㞐|居)
屆	(届|屆)
屉	(屜|屉|𡲕)
届	(屆|届)
屍	(尸|屍)
屏	(摒|屏|屛|拼|秉)
屓	(屃|屭|屓)
屛	(摒|屏|屛|拼|秉)
屜	(屉|𡲕|屜)
属	(屬|𡱆|属)
屡	(屢|屡|屢)
屢	(屡|屢|屢)
屣	(蹝|躧|屣)
層	(层|層)
履	(履|履)
屦	(屨|屦)
屨	(屦|屨)
屩	(蹺|𪨗|屩|跷|蹻|𫏋)
屬	(属|𡱆|屬)
屭	(屓|屃|屭)
屿	(嶼|屿)
岀	(出|岀)
岁	(亗|歲|𡻕|岁|嵗|歳)
岂	(豈|岂|豈)
岐	(歧|岐)
岖	(嶇|㠊|岖)
岗	(岡|崗|冈|岗)
岘	(峴|岘)
岙	(嶴|岙)
岚	(嵐|岚|嵐)
岛	(島|岛|嶋|嶌)
岡	(冈|岗|崗|岡)
岨	(砠|岨)
岩	(巖|岩|巌)
岫	(峀|岫)
岭	(岺|嶺|岭|嶺)
岳	(嶽|岳)
岺	(岭|岺|嶺|嶺)
岽	(崠|崬|岽)
岿	(巋|岿)
峀	(岫|峀)
峄	(嶧|峄)
峒	(洞|峒|洞)
峡	(峽|峡)
峣	(嶢|峣)
峤	(嶠|峤)
峥	(崢|峥)
峦	(巒|峦)
峨	(峩|峨)
峩	(峨|峩)
峭	(陗|峭)
峯	(峰|峯)
峰	(峯|峰)
峴	(岘|峴)
島	(岛|嶋|嶌|島)
峺	(硬|峺|應|应|応)
峽	(峡|峽)
崂	(嶗|崂)
崃	(崍|崃)
崄	(嶮|崄)
崇	(崈|崇)
崈	(崇|崈)
崋	(華|华|崋|蕐)
崍	(崃|崍)
崎	(埼|嵜|碕|崎)
崐	(崑|崐)
崑	(崐|崑)
崒	(崪|崒)
崔	(磪|崔)
崕	(崖|厓|崕)
崖	(厓|崕|崖)
崗	(岗|岡|崗|冈)
崘	(崙|侖|崘|崙|仑)
崙	(侖|崘|崙|仑|崙)
崟	(嶔|崟|嵚)
崠	(岽|崠|崬)
崢	(峥|崢)
崧	(嵩|崧)
崪	(崒|崪)
崬	(岽|崠|崬)
崭	(嶄|崭|巉)
嵆	(嵇|嵆)
嵇	(嵆|嵇)
嵐	(岚|嵐|嵐)
嵗	(歲|亗|岁|嵗|歳|𡻕)
嵘	(嶸|嵘)
嵚	(嶔|崟|嵚)
嵜	(崎|埼|嵜|碕)
嵝	(嶁|嵝)
嵠	(谿|嵠)
嵩	(崧|嵩)
嵯	(嵳|嵯)
嵳	(嵯|嵳)
嵼	(𡶴|嵼)
嶁	(嵝|嶁)
嶃	(磛|嶃)
嶄	(崭|巉|嶄)
嶇	(㠊|岖|嶇)
嶋	(島|岛|嶋|嶌)
嶌	(島|岛|嶋|嶌)
嶎	(蔚|嶎)
嶔	(崟|嵚|嶔)
嶗	(崂|嶗)
嶝	(磴|嶝)
嶠	(峤|嶠)
嶢	(峣|嶢)
嶧	(峄|嶧)
嶮	(崄|嶮)
嶴	(岙|嶴)
嶸	(嵘|嶸)
嶺	(岭|嶺|岺|嶺)
嶼	(屿|嶼)
嶽	(岳|嶽)
巅	(巔|巅|巓)
巉	(嶄|崭|巉)
巋	(岿|巋)
巌	(巖|岩|巌)
巍	(魏|巍)
巒	(峦|巒)
巓	(巔|巅|巓)
巔	(巅|巓|巔)
巖	(岩|巌|巖)
巛	(川|巛)
川	(巛|川)
巡	(廵|巡)
巢	(巣|巢)
巣	(巢|巣)
巤	(剌|鬣|巤)
巨	(鉅|钜|巨)
巩	(鞏|巩)
巯	(巰|巯)
巰	(巯|巰)
巴	(笆|芭|巴)
巵	(卮|巵)
巺	(巽|巺)
巻	(捲|卷|巻)
巽	(巺|巽)
帀	(匝|迊|帀)
币	(幣|币|幤)
布	(佈|布)
帅	(帥|帅)
帆	(㠶|拚|帆|抃)
师	(師|师)
帋	(紙|帋|纸)
希	(稀|希)
帏	(幃|帏)
帐	(帳|帐|賬|账)
帒	(袋|帒)
帘	(簾|帘|簾|𢅏|𢅖|㡘)
帙	(袠|帙)
帚	(箒|菷|帚)
帜	(幟|帜|旘)
帡	(帲|帡)
帥	(帅|帥)
带	(帶|带|帯)
帧	(幀|帧)
師	(师|師)
帬	(裙|帬|裠)
席	(蓆|席)
帮	(幇|幫|帮|幚)
帯	(帶|带|帯)
帰	(歸|帰|归|皈)
帱	(幬|帱)
帲	(帡|帲)
帳	(帐|賬|账|帳)
帶	(带|帯|帶)
帻	(幘|帻)
帼	(幗|帼)
幀	(帧|幀)
幂	(冪|鼏|幂|羃)
幃	(帏|幃)
幇	(帮|幫|幇|幚)
幑	(㫎|幑|𣄈)
幕	(幙|幕)
幗	(帼|幗)
幘	(帻|幘)
幙	(幕|幙)
幚	(幫|帮|幇|幚)
幞	(襮|幞)
幟	(帜|旘|幟)
幡	(旛|幡)
幢	(橦|幢)
幣	(币|幤|幣)
幤	(幣|币|幤)
幫	(帮|幇|幚|幫)
幬	(帱|幬)
幱	(襴|幱|襕)
干	(乾|幹|亁|干|榦)
年	(年|秊|年|秊)
幵	(开|幵|開)
并	(並|併|幷|竝|并|倂|𠊧)
幷	(並|并|竝|幷|併|倂|𠊧)
幸	(倖|囟|幸|䪿|顖)
幹	(干|乾|幹|亁|榦)
幺	(么|幺|麼|麽|庅)
幽	(凼|幽)
幾	(几|幾)
广	(廣|广|広)
庁	(廳|厅|厛|庁|廰)
広	(廣|广|広)
庄	(莊|庄|荘)
庅	(麼|麽|么|庅|幺)
庆	(慶|庆)
床	(牀|床)
庐	(廬|庐|廬)
庑	(廡|庑)
库	(庫|库)
应	(應|应|応|硬|峺)
店	(坫|店)
庙	(廟|庙|庿)
庞	(龐|厐|厖|庞|龎|庬)
废	(廢|废|廃)
度	(度|廓|度|廓)
座	(坐|座)
庫	(库|庫)
庬	(厖|庬|龐|厐|庞|龎)
庵	(菴|庵)
庶	(庻|庶)
庸	(㐯|𠆌|庸)
庻	(庶|庻)
庼	(廎|庼)
庽	(寓|庽)
庾	(斞|㔱|庾)
庿	(廟|庙|庿)
廀	(廋|廀)
廁	(厕|厠|廁)
廂	(厢|廂)
廃	(廢|废|廃)
廄	(厩|廏|廐|廄)
廈	(厦|廈)
廉	(亷|廉|廉)
廊	(廊|廊)
廋	(廀|廋)
廌	(豸|廌)
廎	(庼|廎)
廏	(廄|厩|廏|廐)
廐	(厩|廄|廐|廏)
廑	(厪|廑)
廓	(廓|度|廓|度)
廕	(蔭|廕|荫)
廚	(厨|㕑|廚|𢊍)
廝	(㒋|厮|廝)
廟	(庙|庿|廟)
廠	(厂|厰|廠)
廡	(庑|廡)
廢	(废|廃|廢)
廣	(广|広|廣)
廧	(墻|牆|廧|墙)
廩	(廪|稟|廩|禀)
廪	(廩|稟|廪|禀)
廬	(庐|廬|廬)
廰	(廳|厅|厛|庁|廰)
廱	(雝|廱|簌|𪪝|邕|雍)
廳	(厅|厛|庁|廰|廳)
廵	(巡|廵)
廸	(迪|廸)
廹	(迫|廹)
廻	(回|迴|囘|囬|廻|廽|逥)
廼	(乃|迺|廼)
廽	(回|囘|囬|廻|廽|迴|逥)
廾	(廿|卄|廾)
廿	(卄|廾|廿)
开	(幵|開|开)
弁	(辨|弁|辧|辯|辩)
异	(異|异|異)
弃	(棄|弃)
弄	(瘧|弄|弄|疟)
弈	(奕|弈)
弉	(奘|弉)
弊	(𡚁|弊)
弋	(𢍺|弋)
弌	(一|壹|搋|弌|扠)
弍	(二|貳|弍|貮|贰)
弑	(弒|弑)
弒	(弑|弒)
弔	(吊|弔)
张	(張|张)
弢	(韜|弢|韬)
弥	(彌|弥|瀰|㳽)
弦	(絃|弦)
弪	(弳|弪)
弯	(彎|弯)
弳	(弪|弳)
張	(张|張)
強	(强|彊|強)
弹	(彈|弹|弾)
强	(強|彊|强)
弾	(彈|弹|弾)
彀	(够|夠|彀)
彂	(發|发|彂|発|髮|髪)
彈	(弹|弾|彈)
彊	(強|强|彊)
彌	(弥|瀰|彌|㳽)
彎	(弯|彎)
彐	(彑|彐)
彑	(彐|彑)
归	(歸|帰|归|皈)
当	(噹|當|当)
录	(錄|录|録|錄)
彗	(篲|彗)
彙	(彚|汇|彙|匯|滙)
彚	(彙|彚|汇|匯|滙)
彛	(彝|彛|彜|彞)
彜	(彝|彛|彜|彞)
彝	(彛|彜|彞|彝)
彞	(彝|彛|彜|彞)
彟	(彠|彟)
彠	(彟|彠)
彥	(彦|彥)
彦	(彥|彦)
彨	(彲|彨)
彫	(㓮|雕|鵰|彫|凋|琱)
彬	(份|斌|分|彬)
彲	(彨|彲)
彷	(仿|徬|髣|倣|彷)
彸	(伀|彸)
彻	(徹|彻|澈)
彿	(髴|彿)
往	(徃|迬|往)
征	(征|徵|徴)
徃	(往|徃|迬)
径	(徑|俓|勁|径|迳|逕|劲)
律	(律|律)
後	(后|後)
徑	(俓|勁|径|迳|逕|徑|劲)
徒	(𨑒|徒)
従	(從|从|従)
徕	(徠|來|倈|勑|徕|来|耒|來|俫|勅|敕)
從	(从|従|從)
徠	(來|倈|勑|徕|徠|来|耒|來|俫|勅|敕)
御	(禦|馭|御|雨|驭)
徤	(健|徤)
徧	(遍|徧)
徨	(遑|徨)
復	(复|複|覆|復|復)
徬	(彷|仿|徬|髣|倣)
徭	(傜|徭)
徳	(德|徳|悳|惪)
徴	(徵|征|徴)
徵	(征|徴|徵)
德	(徳|悳|惪|德)
徹	(彻|澈|徹)
徺	(僥|侥|儌|徺)
心	(㣺|忄|心)
忄	(心|㣺|忄)
忆	(憶|忆)
忈	(仁|忈)
忍	(㣼|忍)
忏	(懺|忏|懴)
志	(志|誌)
応	(應|应|応|硬|峺)
忞	(暋|忞|敃)
忤	(啎|迕|忤)
忧	(憂|忧|懮)
忭	(昪|忭)
忰	(悴|忰)
念	(念|念)
忻	(欣|忻)
忼	(慷|忼)
忾	(愾|忾)
怀	(懷|怀|怌|懐)
态	(態|态)
怂	(慫|怂)
怃	(憮|怃)
怄	(慪|嘔|怄|呕)
怅	(悵|怅)
怆	(愴|怆)
怌	(懷|怀|怌|懐)
怒	(怒|怒)
怜	(憐|怜|怜|憐)
怪	(恠|怪)
怱	(匆|悤|怱)
怳	(恍|怳)
总	(總|总|捴|搃|摠|総|縂|𢰾)
怼	(懟|怼|憝|譈)
怿	(懌|怿)
恂	(悛|恂)
恆	(恒|恆)
恊	(勰|協|恊|脅|协|旪|胁|脇)
恋	(戀|恋|戀)
恍	(怳|恍)
恐	(𢙢|恐)
恒	(恆|恒)
恠	(怪|恠)
恡	(吝|悋|恡|吝)
恤	(卹|賉|恤)
恥	(耻|恥)
恩	(摁|恩)
恳	(懇|恳)
恵	(惠|恵)
恶	(噁|惡|恶|悪|惡)
恸	(慟|恸|憅)
恹	(懨|恹)
恺	(愷|恺)
恻	(惻|恻)
恼	(惱|嬲|恼)
恽	(惲|恽)
恿	(慂|恿)
悁	(懁|悁)
悅	(悦|悅)
悊	(哲|喆|悊)
悋	(吝|恡|悋|吝)
悐	(惕|悐)
悚	(𢥠|悚)
悛	(恂|悛)
悞	(悮|誤|悞|误)
悠	(滺|悠)
悤	(匆|怱|悤)
悦	(悅|悦)
您	(你|妳|祢|袮|伱|伲|您|奶|嬭|禰)
悪	(惡|恶|悪|惡|噁)
悫	(愨|慤|悫)
悬	(懸|悬)
悭	(慳|悭)
悮	(悞|悮|誤|误)
悯	(憫|悯|愍)
悳	(德|徳|悳|惪)
悴	(忰|悴)
悵	(怅|悵)
悶	(㥃|懣|闷|悶|懑)
悽	(淒|凄|悽)
惇	(敦|惇)
惊	(驚|惊)
惕	(悐|惕)
惛	(惽|惛)
惝	(𢠵|惝)
惠	(恵|惠)
惡	(恶|悪|惡|噁|惡)
惧	(懼|惧)
惨	(慘|惨)
惩	(懲|惩)
惪	(德|徳|悳|惪)
惫	(憊|惫)
惬	(愜|惬)
惭	(慚|惭|慙)
惮	(憚|惮)
惯	(慣|惯)
惱	(嬲|恼|惱)
惲	(恽|惲)
惷	(蠢|惷)
惺	(醒|𢜫|惺)
惻	(恻|惻)
惽	(惛|惽)
愈	(愉|瘉|癒|愈)
愉	(愈|愉|瘉|癒)
愍	(憫|悯|愍)
愛	(爱|愛)
愜	(惬|愜)
愠	(慍|愠)
愤	(憤|愤)
愦	(憒|愦)
愧	(媿|愧)
愨	(悫|慤|愨)
愬	(訴|愬|诉)
愴	(怆|愴)
愷	(恺|愷)
愻	(遜|愻|逊)
愼	(慎|昚|眘|愼)
愽	(博|愽)
愾	(忾|愾)
愿	(愿|願|𫖸)
慁	(㥵|慁)
慂	(恿|慂)
慄	(栗|慄|慄|栗)
慈	(㤵|慈)
態	(态|態)
慍	(愠|慍)
慎	(愼|慎|昚|眘)
慑	(懾|慑)
慘	(惨|慘)
慙	(慚|惭|慙)
慚	(惭|慙|慚)
慞	(傽|慞)
慟	(恸|憅|慟)
慣	(惯|慣)
慤	(悫|愨|慤)
慪	(嘔|怄|呕|慪)
慫	(怂|慫)
慭	(憖|慭)
慮	(虑|慮)
慳	(悭|慳)
慶	(庆|慶)
慷	(忼|慷)
慼	(慽|慼)
慽	(慼|慽)
慾	(欲|慾)
憂	(忧|懮|憂)
憅	(慟|恸|憅)
憇	(憩|憇)
憊	(惫|憊)
憋	(𢠳|憋)
憐	(怜|憐|憐|怜)
憑	(凭|凴|𠗦|憑)
憒	(愦|憒)
憔	(顦|憔)
憖	(慭|憖)
憙	(喜|憙)
憚	(惮|憚)
憝	(懟|譈|怼|憝)
憤	(愤|憤)
憩	(憇|憩)
憫	(悯|愍|憫)
憮	(怃|憮)
憯	(㦧|憯)
憰	(譎|憰|谲)
憲	(宪|憲)
憶	(忆|憶)
懀	(𢙓|懀)
懁	(悁|懁)
懃	(勤|懃)
懇	(恳|懇)
應	(应|応|硬|應|峺)
懌	(怿|懌)
懍	(懔|凛|懍|凜|凜)
懐	(懷|怀|怌|懐)
懑	(懣|㥃|悶|懑|闷)
懒	(懶|嬾|懒|懶)
懔	(凛|懍|凜|懔|凜)
懜	(懵|懜)
懞	(蒙|懞|朦|矇|苎|苧|薴)
懟	(怼|憝|譈|懟)
懣	(㥃|悶|懑|懣|闷)
懥	(懫|懥)
懨	(恹|懨)
懫	(懥|懫)
懮	(憂|忧|懮)
懲	(惩|懲)
懴	(懺|忏|懴)
懵	(懜|懵)
懶	(嬾|懒|懶|懶)
懷	(怀|怌|懐|懷)
懸	(悬|懸)
懺	(忏|懴|懺)
懼	(惧|懼)
懽	(欢|歡|懽|歓|讙|驩)
懾	(慑|懾)
戀	(恋|戀|戀)
戆	(戇|戆)
戇	(戆|戇)
戉	(鉞|戉|钺)
戋	(戔|戋)
戏	(戲|戏|戯|戱)
戔	(戋|戔)
戗	(戧|創|戗|刅|创|刱|剙|剏)
战	(戰|战|戦)
戛	(戞|戛)
戝	(賊|戝|贼)
戞	(戛|戞)
戦	(戰|战|戦)
戧	(創|戗|刅|创|刱|剙|戧|剏)
戩	(戬|戩)
戬	(戩|戬)
戮	(戮|戮)
戯	(戱|戲|戯|戏)
戰	(战|戦|戰)
戱	(戯|戲|戱|戏)
戲	(戏|戯|戱|戲)
戶	(户|戸|戶)
户	(戶|户|戸)
戸	(戶|户|戸)
戹	(厄|戹|阨|呃|阸)
戻	(戾|戻)
戼	(卯|夘|戼)
戾	(戻|戾)
扁	(碥|艑|扁)
扅	(扊|扅)
扇	(煽|扇|搧)
扊	(扅|扊)
手	(扌|手)
扌	(手|扌)
才	(纔|財|才|㒲|财)
扎	(紮|扎|紥)
扐	(朸|扐)
扑	(撲|扑|攴|攵|夊)
払	(拂|払)
托	(拓|托|摭|拓)
扛	(摃|扛)
扞	(捍|擀|扞)
扠	(搋|壹|弌|扠|一)
执	(執|执)
扩	(擴|扩|拡)
扪	(捫|扪)
扫	(掃|埽|扫)
扬	(揚|扬)
扯	(撦|扯)
扰	(擾|扰)
扱	(插|扱|揷)
扳	(攀|㐴|扳)
扵	(于|亏|於|扵|虧)
扺	(抵|扺)
扼	(㧖|搤|扼)
抃	(拚|帆|抃|㠶)
抉	(刔|抉)
抌	(舀|外|抌)
抍	(基|拯|抍)
抔	(抱|抔)
折	(拃|翼|折)
抚	(撫|抚|拊|捬)
抛	(拋|抛)
抜	(拔|抜)
抝	(拗|抝)
択	(擇|択|择)
抟	(摶|抟)
抠	(摳|抠)
抡	(掄|抡)
抢	(搶|抢)
护	(護|护)
报	(報|报)
披	(㓟|披)
抬	(擡|抬)
抱	(抔|抱)
抵	(扺|抵)
抻	(伸|抻)
抽	(𢭆|抽)
抿	(㨉|抿)
拂	(払|拂)
拃	(折|拃|翼)
担	(擔|担)
拆	(責|拆|责)
拇	(𧿹|拇)
拈	(敁|拈|掂)
拉	(柆|拉|拉)
拊	(撫|抚|拊|捬)
拋	(抛|拋)
拏	(拿|挐|拏|拏)
拐	(枴|拐)
拓	(托|摭|拓|拓)
拔	(抜|拔)
拕	(拖|拕)
拖	(拕|拖)
拗	(抝|拗)
拚	(帆|抃|㠶|拚)
拜	(拝|拜)
拝	(拜|拝)
拟	(擬|儗|拟)
拠	(據|拠|据)
拡	(擴|扩|拡)
拢	(攏|拢)
拣	(揀|拣)
拥	(擁|拥)
拦	(攔|拦)
拧	(擰|拧)
拨	(撥|拨)
择	(擇|択|择)
拭	(𢂑|拭)
拯	(基|抍|拯)
拴	(揎|拴)
拼	(摒|秉|屏|屛|拼)
拽	(曳|拽|曵)
拾	(十|拾|拾)
拿	(拏|挐|拏|拿)
挂	(掛|挂)
挅	(挆|挅)
挆	(挅|挆)
按	(搵|按|揾)
挐	(拏|拿|挐|拏)
挙	(舉|㪯|举|挙|擧)
挚	(摯|挚)
挛	(攣|挛)
挜	(掗|挜)
挝	(撾|挝)
挞	(撻|挞)
挟	(挾|挟)
挠	(撓|挠)
挡	(擋|挡|攩|𫽮)
挢	(撟|嬌|挢|娇)
挣	(掙|挣)
挤	(擠|挤)
挥	(揮|挥)
挦	(撏|挦)
挩	(捝|挩)
挫	(繲|挫)
挭	(骾|鯁|挭|鲠)
挱	(挲|挱)
挲	(挱|挲)
挷	(搒|挷)
挼	(捼|挼)
挽	(掇|輓|挽)
挾	(挟|挾)
捆	(綑|捆)
捉	(杓|捉)
捌	(八|捌)
捍	(扞|捍|擀)
捏	(揑|捏)
捓	(揶|捓)
捜	(搜|捜|𢯱|𢲷)
捝	(挩|捝)
捞	(撈|捞)
损	(損|损)
捡	(撿|捡)
换	(換|换)
捣	(搗|捣|擣|𢭏)
捦	(擒|捦)
捨	(舍|捨|舎)
捫	(扪|捫)
捬	(撫|抚|拊|捬)
据	(據|拠|据)
捲	(卷|巻|捲)
捴	(總|总|捴|搃|摠|総|縂|𢰾)
捵	(䥀|捵)
捶	(搥|箠|捶)
捷	(㨗|捷)
捻	(捻|捻)
捼	(挼|捼)
掂	(敁|拈|掂)
掃	(埽|扫|掃)
掄	(抡|掄)
掆	(㧏|掆)
掇	(挽|掇|輓)
掉	(棹|櫂|卓|掉|桌)
掏	(搯|掏)
掐	(𠜼|掐)
掗	(挜|掗)
掘	(撅|掘)
掙	(挣|掙)
掛	(挂|掛)
掠	(掠|掠)
採	(采|埰|採|釆)
掩	(揜|揞|掩)
掬	(匊|掬)
掲	(揭|掲|結|结)
掳	(擄|掳|虜|擄|虏|虜)
掴	(摑|掴)
掷	(擲|掷|擿)
掸	(撣|掸|撢)
掺	(摻|掺)
掻	(搔|掻)
掼	(摜|掼)
掽	(碰|掽)
揀	(拣|揀)
揅	(研|揅|硎)
揎	(拴|揎)
揑	(捏|揑)
插	(扱|揷|插)
揚	(扬|揚)
換	(换|換)
揜	(掩|揜|揞)
揝	(撍|攢|揝|攅|攒)
揞	(掩|揜|揞)
揦	(攋|揦)
揪	(揫|揪)
揫	(揪|揫)
揭	(掲|結|揭|结)
揮	(挥|揮)
揯	(搄|揯)
揶	(捓|揶)
揷	(插|扱|揷)
揸	(摣|楂|揸|查|槎|査)
揺	(搖|揺|摇)
揽	(攬|㩜|揽|擥|㨫)
揾	(搵|按|揾)
揿	(撳|揿|搇)
搀	(攙|搀)
搁	(擱|搁)
搂	(摟|搂)
搃	(摠|總|搃|𢰾|总|捴|総|縂)
搄	(揯|搄)
搅	(攪|搅|搞|撹)
搆	(構|搆|构)
搇	(撳|揿|搇)
搉	(㩁|搉)
搋	(壹|弌|扠|一|搋)
損	(损|損)
搒	(挷|搒)
搔	(掻|搔)
搖	(揺|摇|搖)
搗	(捣|擣|搗|𢭏)
搜	(捜|𢯱|𢲷|搜)
搞	(攪|搅|搞|撹)
搤	(㧖|扼|搤)
搥	(捶|搥|箠)
搧	(煽|扇|搧)
搨	(搭|搨|撘)
搪	(傏|搪)
搫	(搬|搫)
搬	(搫|搬)
搭	(搨|撘|搭)
搯	(掏|搯)
搵	(按|揾|搵)
搶	(抢|搶)
携	(攜|携)
摁	(恩|摁)
摂	(攝|摂|摄)
摃	(扛|摃)
摄	(攝|摂|摄)
摅	(攄|摅)
摆	(擺|摆)
摇	(搖|揺|摇)
摈	(擯|摈)
摊	(攤|摊)
摋	(𢫬|摋)
摑	(掴|摑)
摒	(屏|屛|拼|摒|秉)
摔	(甩|摔)
摜	(掼|摜)
摟	(搂|摟)
摠	(搃|總|𢰾|摠|总|捴|総|縂)
摡	(溉|摡|漑)
摣	(揸|摣|楂|查|槎|査)
摭	(拓|托|摭|拓)
摮	(𢳆|摮)
摯	(挚|摯)
摳	(抠|摳)
摴	(舒|摴)
摶	(抟|摶)
摻	(掺|摻)
撂	(㨼|撂)
撃	(擊|击|撃)
撄	(攖|撄)
撅	(掘|撅)
撆	(撇|撆)
撇	(撆|撇)
撈	(捞|撈)
撍	(揝|攢|撍|攅|攒)
撏	(挦|撏)
撐	(撑|撐)
撑	(撐|撑)
撓	(挠|撓)
撘	(搭|搨|撘)
撚	(撚|撚)
撝	(㧑|撝)
撟	(嬌|挢|娇|撟)
撢	(撣|掸|撢)
撣	(掸|撢|撣)
撥	(拨|撥)
撦	(扯|撦)
撫	(抚|拊|捬|撫)
撲	(扑|攴|撲|攵|夊)
撳	(揿|搇|撳)
撵	(攆|撵)
撷	(擷|撷)
撸	(擼|撸)
撹	(攪|搅|搞|撹)
撺	(攛|撺)
撻	(挞|撻)
撾	(挝|撾)
撿	(捡|撿)
擀	(扞|捍|擀)
擁	(拥|擁)
擃	(攮|擃)
擄	(掳|虜|擄|擄|虏|虜)
擇	(択|择|擇)
擊	(击|撃|擊)
擋	(挡|攩|𫽮|擋)
擒	(捦|擒)
擓	(㧟|擓)
擔	(担|擔)
擗	(劈|擗)
據	(拠|据|據)
擞	(擻|擞)
擠	(挤|擠)
擡	(抬|擡)
擣	(搗|𢭏|捣|擣)
擥	(㩜|攬|㨫|擥|揽)
擧	(舉|㪯|举|挙|擧)
擬	(儗|拟|擬)
擯	(摈|擯)
擰	(拧|擰)
擱	(搁|擱)
擲	(掷|擿|擲)
擴	(扩|拡|擴)
擷	(撷|擷)
擸	(㧜|擸)
擺	(摆|擺)
擻	(擞|擻)
擼	(撸|擼)
擽	(㧰|擽)
擾	(扰|擾)
擿	(擲|掷|擿)
攀	(㐴|扳|攀)
攄	(摅|攄)
攅	(攢|揝|撍|攅|攒)
攆	(撵|攆)
攋	(揦|攋)
攏	(拢|攏)
攒	(攢|揝|撍|攅|攒)
攔	(拦|攔)
攖	(撄|攖)
攙	(搀|攙)
攛	(撺|攛)
攜	(携|攜)
攝	(摂|摄|攝)
攢	(揝|撍|攅|攒|攢)
攣	(挛|攣)
攤	(摊|攤)
攩	(擋|𫽮|挡|攩)
攪	(搅|搞|撹|攪)
攬	(㩜|揽|擥|㨫|攬)
攮	(擃|攮)
攴	(撲|攵|扑|攴|夊)
攵	(夊|攴|攵|撲|扑)
收	(㧃|収|收)
攷	(考|攷)
敁	(拈|掂|敁)
敃	(暋|忞|敃)
效	(俲|効|效)
敉	(侎|敉)
敌	(敵|敌)
敍	(叙|敘|敍)
敎	(教|敎)
敏	(勄|敏)
敓	(敚|敓)
敕	(勅|勑|敕|倈|徠|俫|來|徕|来|耒|來)
敗	(䢙|败|敗)
敘	(叙|敍|敘)
教	(敎|教)
敚	(敓|敚)
敛	(斂|敛|歛)
敠	(敪|敠)
敦	(惇|敦)
敩	(斅|斆|敩|𢽾|鏰|镚|錋)
敪	(敠|敪)
数	(數|数|數)
敵	(敌|敵)
敷	(尃|旉|敷)
數	(数|數|數)
敺	(驅|敺|駆|駈|驱)
敻	(夐|敻)
敽	(敿|敽)
敿	(敽|敿)
斁	(𤢕|斁)
斂	(敛|歛|斂)
斃	(毙|斃)
斅	(敩|斆|𢽾|斅|鏰|镚|錋)
斆	(敩|斅|鏰|斆|𢽾|镚|錋)
文	(㒚|穩|文|稳)
斈	(學|学|斈)
斉	(齊|亝|斉|斋|齋|齐|斎)
斋	(齊|齋|亝|斉|斋|齐|斎)
斌	(彬|份|斌|分)
斍	(覺|斍|覐|覚|觉)
斎	(齋|斋|斎|齊|亝|斉|齐)
斓	(斕|斓)
斕	(斓|斕)
斗	(鬥|斗|闘|鬦|鬪|鬬|鬭)
料	(料|料)
斚	(斝|斚|檟|榎|槚)
斝	(斚|檟|斝|榎|槚)
斞	(㔱|庾|斞)
斤	(觔|斤|筋)
斥	(㡿|斥)
斩	(斬|斩)
斬	(斩|斬)
断	(斷|断)
斲	(㓸|斵|斲)
斵	(斲|㓸|斵)
斷	(断|斷)
於	(于|亏|扵|於|虧)
斾	(旆|斾)
旁	(傍|旁)
旂	(旗|旂)
旅	(旅|旅)
旆	(斾|旆)
旈	(旒|旈)
旉	(尃|敷|旉)
旒	(旈|旒)
旗	(旂|旗)
旘	(幟|帜|旘)
旛	(幡|旛)
无	(無|无|橆)
既	(旣|既)
旣	(既|旣)
旦	(蛋|旦|疍|蜑)
旧	(舊|旧)
旪	(協|勰|协|恊|旪|脅|胁|脇)
旭	(旮|旯|旭)
旮	(旭|旮|旯)
旯	(旭|旮|旯)
时	(旹|時|时)
旷	(曠|旷|昿)
旸	(暘|旸)
旹	(时|時|旹)
昂	(昻|昂)
昇	(升|昇|陞)
明	(朙|明)
昏	(昬|昏)
昒	(㫚|昒|曶)
易	(易|易)
昙	(曇|昙)
昚	(愼|慎|昚|眘)
昜	(陽|昜|氜|阳)
昝	(偺|喒|咱|昝)
映	(暎|映)
春	(萅|春)
昪	(忭|昪)
昬	(昏|昬)
是	(昰|是)
昰	(是|昰)
昵	(暱|昵)
昶	(暢|昶|畅)
昷	(𥁕|昷)
昻	(昂|昻)
昼	(晝|昼)
昽	(曨|昽)
显	(顯|显|顕)
昿	(曠|旷|昿)
晁	(朝|晁)
時	(时|旹|時)
晃	(晄|晃)
晄	(晃|晄)
晅	(烜|晅)
晉	(晋|晉)
晋	(晉|晋)
晒	(曬|晒)
晓	(曉|晓|暁)
晔	(曄|晔|曅)
晕	(暈|晕|暈)
晖	(暉|晖)
晚	(晩|晚)
晝	(昼|晝)
晡	(𣇀|晡)
晢	(晰|晢|晳)
晩	(晚|晩)
晰	(晢|晳|晰)
晳	(晰|晢|晳)
晴	(晴|晴)
晻	(暗|晻|闇)
暁	(曉|晓|暁)
暂	(暫|暂)
暈	(晕|暈|暈)
暉	(晖|暉)
暋	(忞|敃|暋)
暎	(映|暎)
暖	(娠|煖|㛛|暖|諼|谖)
暗	(晻|闇|暗)
暘	(旸|暘)
暠	(皜|𣉞|暠)
暢	(昶|畅|暢)
暦	(曆|历|厤|暦|歴|歷|曆|厲|歷|厉)
暧	(曖|暧|瞹)
暨	(曁|暨)
暫	(暂|暫)
暱	(昵|暱)
暴	(虣|暴|暴)
暸	(瞭|了|暸|了)
曁	(暨|曁)
曄	(晔|曅|曄)
曅	(曄|晔|曅)
曆	(历|厤|暦|歴|歷|曆|厲|曆|歷|厉)
曇	(昙|曇)
曉	(晓|暁|曉)
曏	(向|嚮|曏)
曖	(暧|瞹|曖)
曜	(燿|耀|曜)
曠	(旷|昿|曠)
曡	(叠|疉|疊|曡|畳|迭)
曥	(𣆐|曥)
曨	(昽|曨)
曬	(晒|曬)
曳	(拽|曵|曳)
更	(㪅|更|更)
曵	(曳|拽|曵)
曶	(㫚|昒|曶)
書	(书|書)
曹	(曺|曹)
曺	(曹|曺)
曼	(㬅|曼)
曽	(曾|曽)
曾	(曽|曾)
朁	(㬱|朁)
朂	(勗|勖|朂)
會	(会|會)
朌	(頒|朌|颁)
朐	(胊|鴝|鸜|朐|鸲)
朖	(朗|朖|朗)
朗	(朖|朗|朗)
朘	(脧|朘)
朙	(明|朙)
望	(朢|望)
朝	(晁|朝)
朞	(期|稘|朞|逞)
期	(朞|逞|期|稘)
朢	(望|朢)
朥	(𦛨|朥)
朦	(矇|蒙|朦|懞|苎|苧|薴)
朧	(矓|胧|朧|眬)
朩	(等|朩)
本	(夲|本)
札	(箚|剳|札|劄)
术	(術|术)
朳	(杷|朳)
朴	(樸|朴)
朵	(朶|朵)
朶	(朵|朶)
朸	(扐|朸)
机	(機|机)
朿	(莿|刺|朿|刾|刺|㓨)
杀	(殺|杀|殺)
杂	(雜|杂|襍|雑)
权	(權|权|権)
杆	(桿|杆)
杇	(圬|杇)
李	(李|李)
村	(邨|村)
杓	(捉|杓)
杝	(柂|杝)
杠	(槓|杠|篢)
条	(條|条|糶|粜)
来	(來|徠|来|耒|來|倈|勑|徕|俫|勅|敕)
杧	(芒|杧)
杨	(楊|杨)
杩	(榪|杩)
杯	(桮|盃|杯)
杰	(傑|杰)
東	(东|東)
杴	(锨|杴)
杷	(朳|杷)
杸	(殳|杸)
杻	(杻|杻)
松	(枀|枩|鬆|松)
板	(版|闆|板)
枀	(松|枀|枩|鬆)
极	(极|極)
构	(構|搆|构)
枏	(楠|枏|枬)
林	(林|林)
果	(菓|果)
枞	(樅|枞)
枢	(樞|枢)
枣	(棗|枣)
枥	(櫪|枥)
枧	(梘|枧)
枨	(棖|枨)
枩	(松|枀|枩|鬆)
枪	(槍|枪)
枫	(楓|枫)
枬	(楠|枏|枬)
枭	(梟|枭|鴞|鸮)
枱	(儓|檯|枱|台|臺|颱)
枴	(拐|枴)
架	(榢|架)
枾	(柹|柿|枾)
柁	(舵|柁)
柂	(杝|柂)
柄	(棅|柄)
柆	(拉|柆|拉)
柏	(孛|栢|柏)
某	(厶|某|私)
柒	(七|漆|柒|㯃|桼)
柚	(櫾|柚)
柜	(櫃|匱|柜|樻|鐀|饋|匮|餽|馈)
柠	(檸|柠)
查	(査|楂|查|揸|槎|摣)
柩	(柾|柩)
柰	(奈|柰|奈)
柳	(檉|柳|柳|柽)
柴	(茈|柴)
柵	(栅|柵)
柹	(枾|柹|柿)
査	(查|査|楂|揸|槎|摣)
柽	(檉|柳|柽|柳)
柾	(柩|柾)
柿	(枾|柹|柿)
栀	(梔|栀)
栄	(榮|栄|荣)
栅	(柵|栅)
标	(標|檁|标|檩)
栈	(棧|栈|桟)
栉	(櫛|栉)
栊	(櫳|㰍|栊)
栋	(棟|栋)
栌	(櫨|栌)
栎	(櫟|栎)
栏	(欄|栏|欄)
树	(樹|树)
栒	(簨|栒)
栖	(棲|栖)
栗	(慄|慄|栗|栗)
栛	(荔|栛|茘)
栝	(檜|栝|桧)
栢	(孛|柏|栢)
栰	(筏|栰)
样	(樣|样|様)
核	(槅|覈|核)
栾	(欒|栾|灤|滦)
桁	(航|桁)
桌	(棹|卓|掉|桌|櫂)
桑	(桒|桑)
桒	(桑|桒)
桜	(櫻|桜|樱)
桟	(棧|栈|桟)
桠	(椏|桠)
桡	(橈|桡)
桢	(楨|桢)
档	(檔|档|欓|𣗋)
桤	(榿|桤)
桥	(橋|桥)
桦	(樺|桦)
桧	(檜|栝|桧)
桨	(槳|桨)
桩	(樁|桩)
桪	(樳|桪)
桮	(杯|桮|盃)
桼	(㯃|漆|桼|柒|七)
桿	(杆|桿)
梁	(樑|梁|梁)
梅	(楳|梅)
梔	(栀|梔)
梘	(枧|梘)
條	(条|糶|條|粜)
梟	(枭|鴞|梟|鸮)
梦	(夢|夣|梦)
梨	(棃|梨|梨)
梲	(棁|棳|梲)
梹	(檳|㯽|梹|槟)
梺	(麓|梺)
梼	(檮|梼)
梾	(棶|梾)
梿	(槤|梿)
检	(檢|检|検)
棁	(梲|棁|棳)
棂	(欞|棂|櫺)
棃	(梨|棃|梨)
棄	(弃|棄)
棅	(柄|棅)
棊	(棋|碁|棊)
棋	(棊|碁|棋)
棐	(榧|棐)
棑	(篺|棑)
棕	(㯶|椶|棕)
棖	(枨|棖)
棗	(枣|棗)
棟	(栋|棟)
棡	(㭎|棡)
棥	(樊|棥)
棧	(栈|桟|棧)
棰	(槌|棰|椎)
棱	(楞|稜|棱|稜)
棲	(栖|棲)
棳	(梲|棁|棳)
棶	(梾|棶)
棹	(卓|掉|桌|櫂|棹)
椀	(盌|碗|椀)
椁	(槨|椁)
椎	(槌|棰|椎)
椏	(桠|椏)
椒	(茭|椒)
椘	(楚|椘)
検	(檢|检|検)
椝	(槼|椝)
椟	(櫝|匵|椟)
椠	(槧|椠)
椢	(槶|椢)
椤	(欏|椤)
椫	(樿|椫)
椭	(橢|椭|楕)
椰	(㭨|椰)
椲	(㭏|椲)
椶	(棕|㯶|椶)
椹	(葚|椹)
楂	(揸|查|槎|摣|楂|査)
楊	(杨|楊)
楓	(枫|楓)
楕	(橢|椭|楕)
楙	(茂|楙)
楚	(椘|楚)
楜	(胡|楜|糊|葫|蝴|衚|鬍)
楞	(棱|稜|楞|稜)
楠	(枏|枬|楠)
楡	(榆|楡)
楥	(楦|楥)
楦	(楥|楦)
楨	(桢|楨)
楫	(檝|艥|楫)
業	(业|業)
楳	(梅|楳)
極	(极|極)
楼	(樓|楼|樓)
楽	(樂|乐|楽|樂|樂|樂)
概	(槩|槪|㮣|概)
榄	(欖|榄)
榅	(榲|榅)
榆	(楡|榆)
榇	(櫬|榇)
榈	(櫚|榈)
榉	(櫸|榉)
榎	(檟|斝|榎|槚|斚)
榘	(矩|榘)
榛	(亲|榛|親)
榢	(架|榢)
榦	(乾|亁|干|榦|幹)
榧	(棐|榧)
榨	(酢|醡|榨|醋|詐|诈)
榪	(杩|榪)
榮	(栄|荣|榮)
榲	(榅|榲)
榴	(橊|榴)
榿	(桤|榿)
槀	(稿|槀|稾)
槅	(核|槅|覈)
槇	(槙|槇)
槊	(鎙|槊)
構	(搆|构|構)
槌	(棰|椎|槌)
槍	(枪|槍)
槎	(楂|揸|查|槎|摣|査)
槓	(杠|篢|槓)
槖	(橐|槖)
様	(樣|样|様)
槙	(槇|槙)
槚	(檟|斝|榎|槚|斚)
槛	(檻|槛)
槜	(檇|槜)
槟	(檳|㯽|梹|槟)
槠	(櫧|槠)
槤	(梿|槤)
槧	(椠|槧)
槨	(椁|槨)
槩	(㮣|概|槩|槪)
槪	(㮣|概|槩|槪)
槳	(桨|槳)
槶	(椢|槶)
槹	(𣓌|槹)
槻	(規|槻|规)
槼	(椝|槼)
樁	(桩|樁)
樂	(乐|楽|樂|樂|樂|樂)
樅	(枞|樅)
樊	(棥|樊)
樐	(㯭|櫓|艪|樐|橹|舮|舻|艣|艫|櫓)
樑	(梁|樑|梁)
樓	(楼|樓|樓)
標	(标|標|檁|檩)
樚	(轆|樚|辘)
樞	(枢|樞)
樢	(㭤|樢)
樣	(样|様|樣)
権	(權|权|権)
横	(橫|横)
樫	(㭴|樫)
樯	(檣|樯|艢)
樱	(櫻|桜|樱)
樳	(桪|樳)
樷	(叢|丛|樷)
樸	(朴|樸)
樹	(树|樹)
樺	(桦|樺)
樻	(匱|櫃|匮|樻|鐀|饋|柜|餽|馈)
樽	(墫|罇|樽|節|卩|节|㔾|部)
樿	(椫|樿)
橆	(無|无|橆)
橇	(鞒|鞽|橇)
橈	(桡|橈)
橊	(榴|橊)
橋	(桥|橋)
橐	(槖|橐)
橓	(蕣|橓)
橛	(橜|橛)
橜	(橛|橜)
機	(机|機)
橢	(椭|楕|橢)
橥	(櫫|橥)
橦	(幢|橦)
橫	(横|橫)
橱	(櫥|橱|櫉)
橹	(櫓|㯭|樐|橹|舮|舻|艣|艪|艫|櫓)
橼	(櫞|橼)
檁	(标|檩|標|檁)
檇	(槜|檇)
檉	(柳|柽|檉|柳)
檐	(簷|檐)
檔	(档|欓|檔|𣗋)
檘	(蘗|檘|蘖|櫱)
檛	(簻|檛)
檜	(栝|桧|檜)
檝	(楫|艥|檝)
檟	(斝|榎|槚|斚|檟)
檠	(𢐧|檠)
檢	(检|検|檢)
檣	(樯|艢|檣)
檩	(檁|标|檩|標)
檭	(𣘴|檭)
檮	(梼|檮)
檯	(儓|台|枱|檯|臺|颱)
檳	(㯽|梹|槟|檳)
檴	(穫|檴|获|獲)
檸	(柠|檸)
檻	(槛|檻)
檼	(櫽|檼)
檾	(䔛|檾)
櫂	(掉|棹|櫂|卓|桌)
櫃	(匱|柜|樻|鐀|饋|匮|櫃|餽|馈)
櫈	(凳|櫈)
櫉	(櫥|橱|櫉)
櫌	(耰|櫌)
櫓	(㯭|樐|橹|舮|舻|艣|艪|艫|櫓|櫓)
櫚	(榈|櫚)
櫛	(栉|櫛)
櫝	(匵|椟|櫝)
櫞	(橼|櫞)
櫟	(栎|櫟)
櫥	(橱|櫉|櫥)
櫧	(槠|櫧)
櫨	(栌|櫨)
櫪	(枥|櫪)
櫫	(橥|櫫)
櫬	(榇|櫬)
櫱	(蘖|櫱|蘗|檘)
櫳	(㰍|栊|櫳)
櫸	(榉|櫸)
櫺	(欞|棂|櫺)
櫻	(桜|樱|櫻)
櫽	(檼|櫽)
櫾	(柚|櫾)
欄	(栏|欄|欄)
權	(权|権|權)
欍	(𣐤|欍)
欏	(椤|欏)
欒	(栾|灤|欒|滦)
欓	(檔|𣗋|档|欓)
欖	(榄|欖)
欝	(鬱|欝|郁|鬰|喐)
欞	(棂|櫺|欞)
欠	(歉|缺|欠)
欢	(懽|歡|欢|歓|讙|驩)
欣	(忻|欣)
欤	(歟|欤)
欧	(歐|欧)
欬	(咳|欬)
欲	(慾|欲)
欵	(款|欵)
欶	(𠲿|欶)
欸	(唉|欸|誒|诶)
欹	(猗|欹)
欼	(啜|歠|欼|諁)
欽	(钦|欽)
款	(欵|款)
歉	(欠|歉|缺)
歌	(謌|歌)
歎	(嘆|叹|歎)
歐	(欧|歐)
歓	(歡|懽|欢|歓|讙|驩)
歕	(呠|噴|歕|喷)
歗	(嘯|啸|嘨|歗)
歛	(斂|敛|歛)
歟	(欤|歟)
歠	(啜|欼|歠|諁)
歡	(懽|欢|歓|讙|驩|歡)
止	(只|子|止|祇|祗|隻)
步	(歩|步)
歧	(岐|歧)
歩	(步|歩)
歯	(齒|歯|齿)
歱	(踵|歱)
歲	(亗|岁|嵗|歳|𡻕|歲)
歳	(歲|亗|岁|嵗|歳|𡻕)
歴	(曆|歷|历|厤|暦|歴|曆|歷|厲|厉)
歷	(历|曆|歴|歷|厲|歷|厤|暦|曆|厉)
歸	(帰|归|皈|歸)
歹	(歺|𣦵|𣦶|歹)
歺	(歹|歺|𣦵|𣦶)
歼	(殲|歼|殱)
歿	(殁|歿)
殀	(夭|殀)
殁	(歿|殁)
殃	(䄃|殃)
殇	(殤|殇)
殉	(侚|狥|殉)
残	(殘|残)
殍	(莩|殍)
殒	(殞|隕|殒|磒|陨)
殓	(殮|殓|殮)
殘	(残|殘)
殚	(殫|殚)
殞	(殒|隕|殞|磒|陨)
殡	(殯|殡)
殤	(殇|殤)
殨	(㱮|殨)
殫	(殚|殫)
殮	(殓|殮|殮)
殯	(殡|殯)
殰	(㱩|𦢌|殰)
殱	(殲|歼|殱)
殲	(歼|殱|殲)
殳	(杸|殳)
殴	(毆|殴)
殺	(杀|殺|殺)
殻	(壳|殼|㱿|殻)
殼	(㱿|壳|殻|殼)
殽	(淆|殽)
毀	(毁|毀)
毁	(毀|毁)
毂	(轂|毂|軲|轱)
毆	(殴|毆)
毎	(每|毎)
每	(毎|每)
毓	(育|毓)
毕	(畢|毕)
毗	(毘|毗)
毘	(毗|毘)
毙	(斃|毙)
毡	(氈|毡|氊)
毧	(㲓|毧)
毬	(球|毬)
毵	(毿|毵)
毿	(毵|毿)
氂	(牦|犛|氂|髦)
氅	(鷩|氅)
氇	(氌|氇)
氈	(毡|氊|氈)
氊	(氈|毡|氊)
氌	(氇|氌)
氓	(甿|氓)
气	(氣|气|気|炁)
気	(氣|气|気|炁)
氜	(阳|陽|氜|昜)
氢	(氫|氢)
氣	(气|気|炁|氣)
氤	(絪|氤)
氩	(氬|氩)
氫	(氢|氫)
氬	(氩|氬)
氯	(綠|氯|緑|绿|綠)
氲	(氳|氲)
氳	(氲|氳)
水	(氵|水)
氵	(水|氵)
氷	(冫|冰|氷)
氼	(溺|尿|氼|溺|氽|脲|尿)
氽	(尿|氽|溺|脲|尿|氼|溺)
氾	(泛|氾|汎)
汇	(匯|彙|汇|滙|彚)
汉	(漢|汉)
汎	(泛|氾|汎)
汙	(汚|污|洿|汙)
汚	(汙|洿|汚|污)
污	(汙|汚|污|洿)
汤	(湯|汤)
汨	(汩|汨)
汩	(汨|汩)
汫	(阱|汫|穽)
汹	(洶|汹)
決	(决|決)
沅	(源|厵|沅)
沈	(沉|瀋|沈|沈)
沉	(沈|瀋|沉|沈)
沍	(冱|沍|沪|滬)
沒	(没|沒)
沖	(冲|盅|沖|衝|𧘂)
沟	(溝|沟)
没	(沒|没)
沢	(澤|沢|泽)
沣	(灃|沣)
沤	(漚|沤)
沥	(瀝|沥)
沦	(淪|沦|淪)
沧	(滄|沧)
沨	(渢|沨)
沩	(溈|沩|潙)
沪	(冱|滬|沍|沪)
沱	(沲|沱)
沲	(沱|沲)
沵	(濔|沵)
沸	(㵒|沸)
況	(况|湟|況)
泄	(洩|渫|泄)
泉	(洤|泉)
泊	(泺|濼|泊)
泌	(泌|泌)
泖	(茅|泖|茆)
泙	(洴|泙)
泛	(氾|汎|泛)
泝	(溯|遡|㴑|泝)
泞	(濘|泞)
泡	(箔|泡)
泥	(坭|泥|泥)
注	(註|注)
泪	(淚|泪|涙|淚)
泶	(澩|泶)
泷	(瀧|泷)
泸	(瀘|泸)
泺	(泊|濼|泺)
泻	(瀉|泻)
泼	(潑|泼|溌)
泽	(澤|沢|泽)
泾	(涇|泾)
洁	(潔|洁)
洌	(冽|洌)
洒	(灑|洒)
洚	(洪|洚)
洛	(洛|洛)
洞	(峒|洞|洞)
洟	(涕|䶏|洟)
洤	(泉|洤)
洩	(泄|渫|洩)
洪	(洚|洪)
洴	(泙|洴)
洶	(汹|洶)
洼	(窪|洼)
洿	(汙|汚|污|洿)
流	(流|流)
浃	(浹|浃)
浄	(淨|净|凈|浄)
浅	(淺|浅)
浆	(漿|浆|𤕯)
浇	(澆|浇)
浈	(湞|浈)
浉	(溮|浉)
浊	(濁|浊)
测	(測|测)
浍	(澮|浍)
济	(濟|济|済)
浏	(瀏|嚠|浏)
浐	(滻|浐)
浑	(渾|浑)
浒	(滸|浒)
浓	(濃|浓)
浔	(潯|浔)
浕	(濜|浕)
浚	(濬|浚)
浜	(濱|浜|滨|濵|瀕|濒)
浣	(澣|浣)
浩	(澔|浩)
浪	(浪|浪)
浹	(浃|浹)
浼	(凂|潣|浼)
涂	(塗|凃|涂)
涅	(湼|涅)
涇	(泾|涇)
涉	(渉|涉)
涌	(湧|涌)
涎	(㳄|涎)
涕	(䶏|洟|涕)
涖	(莅|蒞|涖|𦲷)
涗	(涚|涗)
涙	(淚|泪|涙|淚)
涚	(涗|涚)
涛	(濤|涛)
涜	(瀆|涜|渎)
涝	(澇|涝|潦)
涞	(淶|涞)
涟	(漣|涟|漣)
涠	(潿|涠)
涡	(渦|涡)
涢	(溳|涢)
涣	(渙|涣)
涤	(滌|涤)
润	(潤|润)
涧	(澗|涧|磵)
涨	(漲|涨)
涩	(澀|涩|渋|澁|濇|瀒)
涶	(唾|涶)
涸	(凅|涸)
涼	(凉|鿌|凉|涼)
淀	(澱|淀)
淆	(殽|淆)
淋	(淋|淋)
淒	(凄|悽|淒)
淚	(泪|涙|淚|淚)
淜	(漰|淜)
淡	(澹|淡)
淥	(渌|淥)
淨	(净|凈|浄|淨)
淪	(沦|淪|淪)
淫	(婬|淫)
淳	(湻|淳)
淵	(渊|渕|淵)
淶	(涞|淶)
淸	(清|淸)
淹	(渰|淹)
淺	(浅|淺)
清	(淸|清)
渇	(渴|渇)
済	(濟|济|済)
渉	(涉|渉)
渊	(淵|渊|渕)
渋	(澀|涩|渋|澁|濇|瀒)
渌	(淥|渌)
渍	(漬|渍)
渎	(瀆|涜|渎)
渐	(漸|渐)
渑	(澠|渑)
渓	(溪|渓)
渔	(漁|䱷|渔|䲣)
渕	(淵|渊|渕)
渗	(滲|渗)
渙	(涣|渙)
渚	(陼|渚)
減	(减|減)
渢	(沨|渢)
渦	(涡|渦)
渨	(偎|隈|渨)
温	(溫|温)
渫	(泄|洩|渫)
測	(测|測)
渰	(淹|渰)
渴	(渇|渴)
游	(逰|遊|游)
渹	(訇|𢕐|𥔀|渹)
渾	(浑|渾)
湊	(凑|湊)
湏	(須|湏|须|鬚)
湑	(醑|湑)
湞	(浈|湞)
湟	(況|况|湟)
湧	(涌|湧)
湯	(汤|湯)
湻	(淳|湻)
湼	(涅|湼)
湾	(灣|湾)
湿	(溼|濕|湿)
満	(滿|満|满)
溁	(濚|溁)
溃	(潰|溃)
溅	(濺|溅)
溆	(漵|溆)
溇	(漊|溇)
溈	(沩|潙|溈)
溉	(摡|漑|溉)
溌	(潑|泼|溌)
源	(厵|沅|源)
準	(准|凖|準)
溜	(澑|溜|溜)
溝	(沟|溝)
溪	(渓|溪)
溫	(温|溫)
溮	(浉|溮)
溯	(㴑|泝|遡|溯)
溳	(涢|溳)
溺	(尿|氼|溺|氽|溺|脲|尿)
溻	(褟|溻)
溼	(湿|濕|溼)
溽	(縟|溽|缛)
滄	(沧|滄)
滅	(灭|烕|滅)
滌	(涤|滌)
滎	(荥|滎)
滑	(磆|滑|滑)
滗	(潷|滗)
滙	(匯|汇|滙|彙|彚)
滚	(滾|滚|菌|蕈)
滞	(滯|滞)
滟	(灔|灧|滟|灎|灩)
滠	(灄|滠)
满	(滿|満|满)
滢	(瀅|滢)
滤	(濾|滤|濾)
滥	(濫|滥|濫)
滦	(灤|欒|滦|栾)
滨	(濱|浜|滨|濵|瀕|濒)
滩	(灘|滩|潬)
滪	(澦|滪)
滬	(沪|冱|滬|沍)
滯	(滞|滯)
滲	(渗|滲)
滸	(浒|滸)
滺	(悠|滺)
滻	(浐|滻)
滾	(滚|菌|滾|蕈)
滿	(満|满|滿)
漁	(䱷|渔|䲣|漁)
漆	(㯃|柒|桼|漆|七)
漇	(𢳜|漇)
漊	(溇|漊)
漎	(潨|漎|潀)
漏	(漏|漏)
漑	(溉|摡|漑)
漓	(灕|漓)
漚	(沤|漚)
漢	(汉|漢)
漣	(涟|漣|漣)
漤	(灠|漤)
漫	(澷|漫)
漬	(渍|漬)
漰	(淜|漰)
漱	(潄|漱)
漲	(涨|漲)
漵	(溆|漵)
漸	(渐|漸)
漾	(瀁|漾)
漿	(浆|𤕯|漿)
潀	(潨|漎|潀)
潁	(颍|潁)
潄	(漱|潄)
潅	(灌|潅)
潆	(瀠|潆)
潇	(瀟|潇)
潋	(瀲|潋)
潍	(濰|潍)
潑	(泼|溌|潑)
潔	(洁|潔)
潙	(溈|沩|潙)
潛	(潜|濳|潛)
潜	(潛|潜|濳)
潝	(㴔|潝)
潟	(澙|潟)
潣	(浼|凂|潣)
潤	(润|潤)
潦	(澇|涝|潦)
潨	(漎|潀|潨)
潬	(灘|滩|潬)
潯	(浔|潯)
潰	(溃|潰)
潴	(瀦|潴)
潷	(滗|潷)
潸	(𣽽|潸)
潿	(涠|潿)
澀	(涩|渋|澁|濇|瀒|澀)
澁	(澀|濇|涩|渋|澁|瀒)
澂	(澄|澂)
澄	(澂|澄)
澅	(𣶩|澅)
澆	(浇|澆)
澇	(涝|潦|澇)
澈	(徹|彻|澈)
澑	(溜|澑|溜)
澔	(浩|澔)
澗	(涧|磵|澗)
澙	(潟|澙)
澛	(瀂|澛)
澜	(瀾|澜)
澠	(渑|澠)
澣	(浣|澣)
澤	(沢|泽|澤)
澦	(滪|澦)
澩	(泶|澩)
澮	(浍|澮)
澱	(淀|澱)
澳	(襖|𥜌|澳|袄)
澷	(漫|澷)
澹	(淡|澹)
澾	(㳠|澾)
濁	(浊|濁)
濃	(浓|濃)
濄	(㳡|濄)
濆	(𣸣|濆)
濇	(澀|澁|瀒|涩|渋|濇)
濑	(瀨|濑|瀬)
濒	(瀕|濒|濱|濵|浜|滨)
濔	(沵|濔)
濕	(湿|溼|濕)
濘	(泞|濘)
濚	(溁|濚)
濛	(霥|靀|濛)
濜	(浕|濜)
濟	(济|済|濟)
濤	(涛|濤)
濧	(㳔|濧)
濫	(滥|濫|濫)
濬	(浚|濬)
濰	(潍|濰)
濱	(浜|滨|濵|瀕|濱|濒)
濳	(潛|潜|濳)
濵	(濱|瀕|浜|滨|濵|濒)
濶	(闊|濶|阔)
濺	(溅|濺)
濼	(泊|泺|濼)
濾	(滤|濾|濾)
濿	(砅|濿)
瀁	(漾|瀁)
瀂	(澛|瀂)
瀃	(𣽷|瀃)
瀅	(滢|瀅)
瀆	(涜|渎|瀆)
瀇	(㲿|瀇)
瀉	(泻|瀉)
瀋	(沈|沉|沈|瀋)
瀏	(嚠|浏|瀏)
瀒	(澀|濇|涩|渋|澁|瀒)
瀕	(濒|濱|濵|瀕|浜|滨)
瀘	(泸|瀘)
瀝	(沥|瀝)
瀟	(潇|瀟)
瀠	(潆|瀠)
瀦	(潴|瀦)
瀧	(泷|瀧)
瀨	(濑|瀬|瀨)
瀬	(瀨|濑|瀬)
瀰	(㳽|彌|瀰|弥)
瀲	(潋|瀲)
瀾	(澜|瀾)
灃	(沣|灃)
灄	(滠|灄)
灌	(潅|灌)
灎	(灔|滟|灎|灧|灩)
灏	(灝|灏)
灑	(洒|灑)
灔	(滟|灎|灧|灩|灔)
灕	(漓|灕)
灘	(滩|潬|灘)
灙	(𣺼|灙)
灝	(灏|灝)
灠	(漤|灠)
灡	(㳕|灡)
灣	(湾|灣)
灤	(欒|滦|栾|灤)
灧	(滟|灔|灧|灎|灩)
灩	(灔|滟|灎|灧|灩)
火	(灬|火)
灬	(火|灬)
灭	(滅|灭|烕)
灮	(光|灮)
灯	(燈|灯)
灰	(灰|灰)
灴	(烘|灴)
灵	(靈|灵|霊|靈)
灶	(竃|竈|灶)
災	(灾|烖|菑|災|甾)
灾	(災|烖|菑|灾|甾)
灿	(燦|灿)
炀	(煬|炀|烊)
炁	(氣|气|気|炁)
炅	(耿|炅|炔)
炉	(爐|炉|爐)
炔	(耿|炅|炔)
炙	(炙|炙)
炜	(煒|炜)
炝	(熗|炝)
炤	(照|炤)
炫	(衒|炫)
炮	(炰|砲|礮|炮|礟)
炯	(烱|炯)
炰	(炮|炰|砲|礮|礟)
炸	(煠|炸)
点	(點|奌|点)
為	(为|爲|為)
炼	(煉|炼|錬|煉)
炽	(熾|炽)
烁	(爍|烁)
烂	(爛|烂|燗|爛)
烃	(烴|烃)
烈	(烈|烈)
烉	(煥|烉|焕)
烊	(煬|炀|烊)
烏	(乌|烏)
烕	(滅|灭|烕)
烖	(災|灾|菑|烖|甾)
烘	(灴|烘)
烙	(烙|烙)
烛	(燭|烛)
烜	(晅|烜)
烝	(蒸|烝)
烟	(完|煙|菸|烟)
烦	(煩|烦)
烧	(燒|烧|焼|簫|箫|箾|簘)
烨	(燁|烨)
烩	(燴|烩)
烫	(燙|烫)
烬	(燼|烬)
热	(熱|热|𤍠)
烱	(炯|烱)
烴	(烃|烴)
焔	(焰|焔|燄)
焕	(煥|烉|焕)
焖	(燜|焖)
焘	(燾|焘)
無	(无|橆|無)
焦	(焳|焦)
焭	(煢|焭|茕)
焰	(焔|燄|焰)
焳	(焦|焳)
焼	(燒|烧|焼|簫|箫|箾|簘)
煅	(鍛|煅|锻)
煆	(鍜|煆)
煇	(輝|煇|辉)
煉	(炼|錬|煉|煉)
煑	(煮|煑)
煒	(炜|煒)
煕	(熙|煕|熈)
煖	(娠|暖|諼|㛛|煖|谖)
煙	(完|烟|菸|煙)
煠	(炸|煠)
煢	(焭|茕|煢)
煥	(烉|焕|煥)
照	(炤|照)
煩	(烦|煩)
煬	(炀|烊|煬)
煮	(煑|煮)
煱	(㶽|煱)
煳	(㷻|煳)
煴	(熅|煴)
煽	(扇|搧|煽)
熅	(煴|熅)
熇	(燺|熇)
熈	(熙|煕|熈)
熉	(𤈶|熉)
熌	(𤇄|熌)
熏	(燻|𤑕|熏|爋)
熒	(荧|熒)
熓	(𤆡|熓)
熔	(鎔|熔|镕)
熗	(炝|熗)
熙	(煕|熈|熙)
熡	(𤋏|熡)
熨	(㷉|尉|熨)
熱	(热|𤍠|熱)
熲	(颎|熲)
熹	(熺|熹)
熺	(熹|熺)
熾	(炽|熾)
燁	(烨|燁)
燄	(焰|焔|燄)
燈	(灯|燈)
燎	(燎|燎)
燐	(㷠|粦|燐|燐)
燒	(烧|焼|簫|燒|箫|箾|簘)
燕	(讌|醼|鷰|䜩|宴|燕)
燗	(爛|烂|燗|爛)
燙	(烫|燙)
燜	(焖|燜)
營	(営|营|營)
燣	(燷|燣)
燦	(灿|燦)
燭	(烛|燭)
燴	(烩|燴)
燶	(㶶|燶)
燷	(燣|燷)
燺	(熇|燺)
燻	(熏|燻|𤑕|爋)
燼	(烬|燼)
燾	(焘|燾)
燿	(曜|耀|燿)
爄	(𤇃|爄)
爋	(𤑕|熏|爋|燻)
爍	(烁|爍)
爐	(炉|爐|爐)
爛	(烂|燗|爛|爛)
爪	(㕚|爫|爪)
爫	(㕚|爪|爫)
爭	(争|爭)
爱	(愛|爱)
爲	(為|为|爲)
爷	(爺|爷)
爺	(爷|爺)
爼	(俎|爼)
爾	(尒|尓|尔|爾)
爿	(丬|𤕪|爿)
牀	(床|牀)
牄	(蹌|牄|跄)
牆	(墙|墻|廧|牆)
版	(板|版|闆)
牋	(箋|牋|笺)
牍	(牘|牍)
牕	(窓|窗|窻|䆫|牕)
牘	(牍|牘)
牛	(牜|牛)
牜	(牛|牜)
牟	(麰|牟)
牠	(他|它|她|牠|佗)
牢	(牢|牢)
牦	(氂|犛|牦|髦)
牴	(牴|羝|觝)
牵	(牽|牵)
牺	(犧|牺|犠)
牽	(牵|牽)
犁	(犂|犁)
犂	(犁|犂)
犄	(踦|犄)
犇	(奔|犇|逩)
犊	(犢|犊)
犖	(荦|犖)
犛	(氂|牦|髦|犛)
犠	(犧|牺|犠)
犢	(犊|犢)
犧	(牺|犠|犧)
犬	(犭|犬)
犭	(犬|犭)
犲	(豺|犲)
犴	(豻|犴)
状	(狀|状|狀)
犷	(獷|犷)
犸	(獁|犸)
犹	(猶|犹)
狀	(状|狀|狀)
狈	(狽|狈)
狝	(獮|狝)
狞	(獰|狞)
狢	(貉|狢)
狥	(侚|殉|狥)
独	(獨|独)
狭	(狹|狭|陜|陝|陕)
狮	(獅|狮)
狯	(獪|狯|猾)
狰	(猙|狰)
狱	(獄|狱)
狲	(猻|狲)
狵	(尨|狵|龍|竜|龒|龙|龍)
狷	(獧|狷)
狸	(貍|狸)
狹	(狭|陜|狹|陝|陕)
狻	(䝜|狻)
狼	(狼|狼)
狽	(狈|狽)
猃	(獫|猃|玁|𤞤)
猇	(唬|虓|猇|諕)
猋	(颮|飇|猋|飑)
猎	(獵|猎|猟|獵|𤢪)
猕	(獼|猕)
猗	(欹|猗)
猙	(狰|猙)
猟	(獵|猎|猟|獵|𤢪)
猡	(玀|猡)
猨	(猿|蝯|猨)
猪	(豬|猪|猪)
猫	(貓|猫)
猬	(蝟|猬)
献	(獻|献)
猶	(犹|猶)
猻	(狲|猻)
猾	(獪|狯|猾)
猿	(猨|蝯|猿)
獁	(犸|獁)
獃	(呆|獃|騃|𫘤)
獄	(狱|獄)
獅	(狮|獅)
獎	(奖|奬|獎|奨)
獐	(麞|獐)
獠	(䝤|獠)
獣	(獸|兽|獣)
獧	(狷|獧)
獨	(独|獨)
獪	(狯|猾|獪)
獫	(猃|玁|獫|𤞤)
獭	(獺|獭)
獮	(狝|獮)
獰	(狞|獰)
獱	(㺍|獱)
獲	(获|獲|穫|檴)
獵	(猎|猟|獵|𤢪|獵)
獷	(犷|獷)
獸	(兽|獣|獸)
獺	(獭|獺)
獻	(献|獻)
獼	(猕|獼)
獾	(貛|獾)
玀	(猡|玀)
玁	(獫|𤞤|猃|玁)
玄	(伭|玄)
玅	(妙|玅)
玆	(兹|茲|玆)
率	(率|率|率)
玑	(璣|玑)
玖	(九|玖)
玙	(璵|玙)
玚	(瑒|玚)
玛	(瑪|玛)
玟	(玫|珉|玟|䃉|砇)
玫	(玟|玫|珉|䃉|砇)
玮	(瑋|玮)
环	(環|环)
现	(現|现)
玱	(瑲|玱)
玲	(玲|玲)
玳	(瑇|玳)
玺	(璽|壐|玺)
珉	(䃉|玟|砇|珉|玫)
珍	(珎|珍)
珎	(珍|珎)
珐	(琺|珐)
珑	(瓏|珑)
珞	(珞|珞)
珪	(圭|珪)
珰	(璫|珰)
珲	(琿|珲)
珶	(瑅|珶)
珷	(碔|珷)
現	(现|現)
球	(毬|球)
琄	(鞙|琄)
琅	(瑯|琅)
理	(理|理)
琉	(瑠|璢|琉|琉)
琎	(璡|琎)
琏	(璉|琏|璉)
琐	(瑣|琐)
琱	(雕|㓮|凋|彫|琱|鵰)
琺	(珐|琺)
琼	(瓊|琼)
琿	(珲|琿)
瑅	(珶|瑅)
瑇	(玳|瑇)
瑋	(玮|瑋)
瑒	(玚|瑒)
瑙	(碯|瑙)
瑠	(琉|瑠|璢|琉)
瑣	(琐|瑣)
瑤	(瑶|瑤)
瑩	(莹|瑩|瑩)
瑪	(玛|瑪)
瑯	(琅|瑯)
瑲	(玱|瑲)
瑶	(瑤|瑶)
瑷	(璦|瑷)
瑸	(璸|瑸)
瑽	(𪻐|瑽)
璁	(𤧚|璁)
璃	(瓈|璃)
璇	(璿|璇)
璉	(琏|璉|璉)
璎	(瓔|璎)
璘	(璘|璘)
璡	(琎|璡)
璢	(琉|瑠|璢|琉)
璣	(玑|璣)
璦	(瑷|璦)
璫	(珰|璫)
璯	(㻅|璯)
環	(环|環)
璵	(玙|璵)
璸	(瑸|璸)
璽	(壐|玺|璽)
璿	(璇|璿)
瓈	(璃|瓈)
瓊	(琼|瓊)
瓏	(珑|瓏)
瓒	(瓚|瓒)
瓔	(璎|瓔)
瓕	(𤦀|瓕)
瓚	(瓒|瓚)
瓟	(匏|瓟)
瓮	(甕|罋|瓮)
瓯	(甌|瓯)
瓶	(甁|缾|瓶)
瓷	(甆|磁|瓷)
甁	(瓶|甁|缾)
甆	(瓷|甆|磁)
甌	(瓯|甌)
甎	(磚|甎|砖)
甕	(瓮|罋|甕)
甖	(罃|罌|甖|罂)
甚	(什|什|甚)
甛	(甜|甛)
甜	(甛|甜)
甞	(嘗|尝|甞)
產	(产|産|產)
産	(產|产|産)
甤	(蕤|甤)
甦	(穌|甦|稣)
甩	(摔|甩)
甪	(角|甪)
甬	(埇|甬)
甯	(寗|甯)
电	(電|电)
町	(圢|町)
画	(畫|画|畵)
甽	(畎|甽)
甾	(菑|災|灾|烖|甾)
甿	(氓|甿)
畄	(留|畱|畄|留)
畅	(暢|昶|畅)
畆	(畝|亩|畆|畒|畮)
畊	(耕|畊|簡|简)
界	(堺|畍|界)
畍	(界|堺|畍)
畎	(甽|畎)
畒	(畝|亩|畆|畒|畮)
留	(畄|畱|留|留)
畝	(亩|畆|畒|畮|畝)
畢	(毕|畢)
略	(畧|略|略)
畧	(略|畧|略)
番	(蹯|番)
畫	(画|畵|畫)
畬	(畭|畲|畬)
畭	(畬|畭|畲)
畮	(畝|亩|畆|畒|畮)
異	(异|異|異)
畱	(畄|留|畱|留)
畲	(畬|畭|畲)
畳	(疊|叠|曡|畳|疉|迭)
畴	(疇|畴)
畵	(畫|画|畵)
當	(当|噹|當)
畺	(將|疆|将|畺|𤕭)
畽	(疃|畽)
疃	(畽|疃)
疆	(將|畺|将|疆|𤕭)
疇	(畴|疇)
疉	(曡|疊|叠|疉|畳|迭)
疊	(叠|曡|畳|疉|迭|疊)
疋	(匹|疋)
疍	(蛋|旦|疍|蜑)
疎	(疏|疎)
疏	(疎|疏)
疖	(癤|疖)
疗	(療|疗|療)
疟	(瘧|弄|疟|弄)
疠	(癘|疠)
疡	(瘍|疡)
疣	(肬|疣)
疬	(癧|疬)
疭	(瘲|疭)
疮	(瘡|疮)
疯	(瘋|疯)
疱	(皰|疱)
疴	(痾|疴)
疸	(癉|疸|瘅)
疹	(胗|疹)
症	(癥|症)
痈	(癰|痈)
痉	(痙|痉)
痐	(蚘|痐|蛔|蛕|蜖)
痒	(癢|痒)
痖	(瘂|啞|痖|哑|唖)
痙	(痉|痙)
痢	(痢|痢)
痨	(癆|痨)
痩	(瘦|痩)
痪	(瘓|痪)
痫	(癇|痫)
痮	(脹|痮|胀)
痲	(痳|痲)
痳	(痲|痳)
痴	(癡|痴)
痹	(痺|痹)
痺	(痹|痺)
痼	(㽽|痼)
痾	(疴|痾)
瘂	(啞|痖|哑|唖|瘂)
瘅	(癉|疸|瘅)
瘆	(瘮|瘆)
瘉	(愈|癒|愉|瘉)
瘋	(疯|瘋)
瘍	(疡|瘍)
瘓	(痪|瘓)
瘗	(瘞|瘗)
瘘	(瘺|瘘|瘻)
瘞	(瘗|瘞)
瘡	(疮|瘡)
瘦	(痩|瘦)
瘧	(弄|疟|瘧|弄)
瘨	(癲|瘨|癫)
瘪	(癟|瘪)
瘫	(癱|瘫)
瘮	(瘆|瘮)
瘲	(疭|瘲)
瘶	(嗽|瘶)
瘺	(瘘|瘻|瘺)
瘻	(瘺|瘘|瘻)
瘾	(癮|瘾)
瘿	(癭|瘿)
療	(疗|療|療)
癆	(痨|癆)
癇	(痫|癇)
癉	(疸|瘅|癉)
癒	(愈|瘉|愉|癒)
癘	(疠|癘)
癛	(癝|癛)
癝	(癛|癝)
癞	(癩|癞|癩)
癟	(瘪|癟)
癡	(痴|癡)
癢	(痒|癢)
癣	(癬|癣)
癤	(疖|癤)
癥	(症|癥)
癧	(疬|癧)
癨	(霍|癨)
癩	(癞|癩|癩)
癫	(癲|瘨|癫)
癬	(癣|癬)
癭	(瘿|癭)
癮	(瘾|癮)
癯	(臞|癯)
癰	(痈|癰)
癱	(瘫|癱)
癲	(瘨|癫|癲)
発	(發|发|彂|発|髮|髪)
登	(豋|登)
發	(发|彂|発|發|髮|髪)
百	(佰|百)
皁	(皂|皁)
皂	(皁|皂)
皃	(貌|貎|皃)
皈	(歸|帰|归|皈)
皋	(皐|睾|臯|皋|𦤎)
皎	(㿟|皦|皎)
皐	(皋|皐|睾|臯|𦤎)
皑	(皚|皑)
皓	(皝|顥|皓|颢)
皚	(皑|皚)
皜	(暠|皜|𣉞)
皝	(皓|顥|皝|颢)
皞	(皡|皥|皞)
皟	(𤾀|皟)
皡	(皞|皥|皡)
皥	(皞|皡|皥)
皦	(㿟|皎|皦)
皰	(疱|皰)
皱	(皺|皱|縐|绉)
皲	(皸|皲)
皷	(鼓|鼔|皷|皼)
皸	(皲|皸)
皺	(皱|縐|皺|绉)
皼	(鼓|皷|皼|鼔)
盃	(杯|桮|盃)
盅	(沖|冲|盅|衝|𧘂)
盇	(盍|盇)
益	(益|益)
盌	(椀|碗|盌)
盍	(盇|盍)
盏	(盞|盏)
盐	(鹽|䀋|塩|盐|𥂁)
监	(監|监)
盖	(葢|蓋|盖)
盗	(盜|盗)
盘	(盤|盘)
盙	(簠|盙)
盜	(盗|盜)
盞	(盏|盞)
盡	(尽|儘|盡|侭)
監	(监|監)
盤	(盘|盤)
盧	(卢|盧|盧)
盩	(盭|盩)
盪	(荡|蕩|蘯|逿|𨌩|盪|偒)
盭	(盩|盭)
省	(省|省)
眇	(緲|眇|缈)
眈	(躭|眈|耽)
眍	(瞘|眍)
眎	(視|眎|视)
眘	(愼|慎|昚|眘)
眙	(瞪|眙|瞠)
眞	(真|眞)
真	(眞|真)
眠	(緡|眠|缗)
眥	(眦|眥)
眦	(眥|眦)
眬	(矓|朧|眬|胧)
眾	(众|衆|𠂝|眾)
着	(著|着|螫)
睁	(睜|睁)
睍	(𪾢|睍)
睏	(困|睏)
睐	(睞|睐)
睑	(瞼|睑)
睜	(睁|睜)
睞	(睐|睞)
睫	(䀹|睫|𥅴)
睹	(覩|睹)
睾	(皋|皐|睾|臯|𦤎)
睿	(叡|睿)
瞅	(矁|𬑡|瞅)
瞆	(瞶|瞆)
瞍	(𥈟|瞍)
瞒	(瞞|瞒)
瞘	(眍|瞘)
瞜	(䁖|瞜)
瞞	(瞒|瞞)
瞠	(瞪|眙|瞠)
瞤	(𥆧|瞤)
瞥	(苤|瞥)
瞩	(矚|瞩)
瞪	(眙|瞠|瞪)
瞬	(䀢|瞬)
瞭	(了|暸|瞭|了)
瞯	(瞷|瞯)
瞰	(矙|瞰)
瞶	(瞆|瞶)
瞷	(瞯|瞷)
瞹	(曖|暧|瞹)
瞼	(睑|瞼)
瞿	(䀠|瞿)
矁	(瞅|𬑡|矁)
矇	(朦|蒙|矇|懞|苎|苧|薴)
矈	(矏|矈)
矋	(矖|矋)
矏	(矈|矏)
矓	(朧|眬|矓|胧)
矖	(矋|矖)
矙	(瞰|矙)
矚	(瞩|矚)
矢	(笶|矢)
矧	(訠|矧)
矩	(榘|矩)
矫	(矯|矫)
矮	(躷|矮)
矯	(矫|矯)
矰	(蹭|矰)
石	(𥐘|石)
矶	(磯|矶)
矾	(礬|矾)
矿	(礦|矿|砿|鉱|鑛)
砀	(碭|砀)
码	(碼|码)
砅	(濿|砅)
砇	(珉|䃉|玟|砇|玫)
砌	(纖|砌|繊|纎|纤|縴)
砒	(磇|砒)
研	(揅|硎|研)
砕	(碎|砕)
砖	(磚|甎|砖)
砗	(硨|砗)
砚	(硯|砚)
砜	(碸|砜)
砠	(岨|砠)
砣	(鉈|𥓿|砣|铊)
砥	(厎|砥)
砦	(寨|砦)
砧	(碪|砧)
砲	(炮|礮|炰|砲|礟)
砺	(礪|砺|礪)
砻	(礱|砻|𤮨)
砾	(礫|砾)
砿	(礦|矿|砿|鉱|鑛)
础	(礎|础)
硁	(硜|䃘|硁|踁)
硎	(研|揅|硎)
硕	(碩|硕)
硖	(硤|唊|硖)
硗	(磽|墝|硗)
硙	(磑|硙)
硚	(礄|硚)
硜	(䃘|硁|踁|硜)
硤	(唊|硖|硤)
硨	(砗|硨)
硫	(硫|硫)
硬	(峺|應|硬|应|応)
硭	(𥐞|硭)
确	(確|确)
硯	(砚|硯)
硵	(磠|硵)
硷	(礆|鹼|硷|險|堿|碱|鹸|鹻|险|険)
碁	(棊|棋|碁)
碌	(碌|碌)
碍	(㝵|礙|碍)
碎	(砕|碎)
碔	(珷|碔)
碕	(崎|埼|嵜|碕)
碗	(椀|盌|碗)
碙	(𥐻|碙)
碛	(磧|碛)
碜	(磣|碜)
碥	(扁|碥|艑)
碩	(硕|碩)
碪	(砧|碪)
碭	(砀|碭)
碯	(瑙|碯)
碰	(掽|碰)
碱	(鹻|鹼|堿|碱|硷|鹸|礆|險|险|険)
碸	(砜|碸)
確	(确|確)
碼	(码|碼)
碽	(䂵|碽)
磁	(瓷|甆|磁)
磆	(滑|磆|滑)
磇	(砒|磇)
磊	(磥|磊|磊)
磌	(𧰊|磌)
磑	(硙|磑)
磒	(隕|殒|殞|磒|陨)
磚	(甎|砖|磚)
磛	(嶃|磛)
磠	(硵|磠)
磡	(墈|磡)
磣	(碜|磣)
磥	(磊|磥|磊)
磧	(碛|磧)
磪	(崔|磪)
磯	(矶|磯)
磴	(嶝|磴)
磵	(澗|涧|磵)
磻	(磻|磻)
磽	(墝|硗|磽)
礄	(硚|礄)
礆	(硷|險|礆|鹼|险|険|堿|碱|鹸|鹻)
礎	(础|礎)
礒	(𥐟|礒)
礙	(㝵|碍|礙)
礟	(礮|炮|砲|礟|炰)
礡	(礴|礡)
礦	(矿|砿|鉱|鑛|礦)
礪	(砺|礪|礪)
礫	(砾|礫)
礬	(矾|礬)
礮	(炮|砲|礟|炰|礮)
礱	(砻|𤮨|礱)
礴	(礡|礴)
礶	(罐|礶|缶|鑵|缻)
示	(礻|示)
礻	(示|礻)
礼	(禮|礼|礼|禮)
礿	(禴|礿)
祃	(禡|祃)
祇	(只|子|止|祇|祗|隻)
祎	(禕|祎)
祐	(佑|祐)
祕	(秘|祕)
祗	(只|子|止|祇|祗|隻)
祘	(算|祘|筭)
神	(神|神)
祢	(你|妳|您|禰|袮|伱|伲|祢|奶|嬭)
祥	(祥|祥)
祯	(禎|祯)
祷	(禱|祷|禂)
祸	(禍|祸)
祺	(禥|祺)
祿	(禄|祿|祿)
禀	(稟|廩|廪|禀)
禂	(禱|祷|禂)
禄	(祿|禄|祿)
禅	(禪|禅)
禍	(祸|禍)
禎	(祯|禎)
福	(福|福)
禕	(祎|禕)
禡	(祃|禡)
禥	(祺|禥)
禦	(御|禦|馭|雨|驭)
禪	(禅|禪)
禮	(礼|禮|礼|禮)
禰	(祢|你|妳|您|禰|袮|伱|伲|奶|嬭)
禱	(祷|禂|禱)
禴	(礿|禴)
离	(離|离|離)
禿	(秃|禿)
私	(厶|某|私)
秃	(禿|秃)
秄	(耔|秄)
秆	(稈|秆)
秇	(埶|蓺|藝|秇|兿|艺|芸|蕓)
秈	(籼|秈)
秉	(拼|摒|秉|屏|屛)
秊	(秊|年|秊|年)
秋	(䆋|秌|穐|龝|秋)
秌	(秋|䆋|秌|穐|龝)
种	(種|种)
秏	(耗|秏)
秐	(耘|秐)
秔	(稉|粳|秔)
秕	(粃|秕)
秘	(祕|秘)
秤	(稱|偁|秤|称|穪)
积	(積|积)
称	(稱|偁|秤|称|穪)
秸	(稭|秸)
移	(迻|移)
秽	(穢|秽)
秾	(穠|秾)
稀	(希|稀)
稅	(税|稅)
稆	(穭|稆|穞)
稈	(秆|稈)
稉	(秔|粳|稉)
稊	(䄺|稊)
税	(稅|税)
稏	(䅉|稏)
稘	(朞|期|稘|逞)
稚	(䕌|稺|穉|稚)
稜	(棱|楞|稜|稜)
稟	(廩|廪|禀|稟)
稣	(穌|甦|稣)
稬	(糯|稬|穤|粫|𥻟)
稭	(秸|稭)
種	(种|種)
稱	(偁|秤|称|穪|稱)
稲	(稻|稲)
稳	(穩|㒚|文|稳)
稺	(稚|䕌|稺|穉)
稻	(稲|稻)
稽	(乩|稽)
稾	(稿|槀|稾)
稿	(槀|稾|稿)
穀	(糓|谷|穀)
穂	(穗|穂)
穅	(糠|穅)
穉	(稚|䕌|稺|穉)
穌	(甦|稣|穌)
積	(积|積)
穎	(署|頴|颖|穎|颕)
穐	(秋|䆋|秌|穐|龝)
穑	(穡|穑)
穗	(穂|穗)
穞	(穭|稆|穞)
穠	(秾|穠)
穡	(穑|穡)
穢	(秽|穢)
穣	(穰|穣)
穤	(糯|稬|穤|粫|𥻟)
穨	(𬓼|穨)
穩	(㒚|文|稳|穩)
穪	(偁|稱|穪|秤|称)
穫	(檴|获|穫|獲)
穭	(稆|穞|穭)
穰	(穣|穰)
穷	(窮|穷|竆)
穽	(阱|汫|穽)
窃	(竊|窃)
窌	(窖|窌)
窍	(竅|窍)
窎	(窵|窎)
窑	(窯|窑|窰)
窓	(䆫|牕|窗|窻|窓)
窕	(阿|啊|窕)
窖	(窌|窖)
窗	(䆫|牕|窓|窻|窗)
窜	(竄|窜)
窝	(窩|窝)
窥	(窺|窥)
窦	(竇|窦)
窩	(窝|窩)
窪	(洼|窪)
窭	(窶|寠|窭)
窮	(穷|竆|窮)
窯	(窑|窰|窯)
窰	(窯|窑|窰)
窴	(塡|填|窴)
窵	(窎|窵)
窶	(寠|窭|窶)
窺	(窥|窺)
窻	(牕|窓|窗|窻|䆫)
竃	(灶|竃|竈)
竄	(窜|竄)
竅	(窍|竅)
竆	(窮|穷|竆)
竇	(窦|竇)
竈	(灶|竃|竈)
竉	(䆔|𥥅|竉)
竊	(窃|竊)
立	(立|立)
竒	(奇|竒)
竖	(豎|竖|竪)
竚	(佇|伫|竚)
竜	(龍|尨|竜|龒|龙|龍|狵)
竝	(並|并|幷|竝|併|倂|𠊧)
竞	(競|竞|竸|誩)
竢	(俟|竢)
竪	(豎|竖|竪)
競	(竞|竸|誩|競)
竸	(競|竞|竸|誩)
竻	(簕|𥵚|竻)
竾	(篪|竾|箎)
竿	(𣔼|竿)
笃	(篤|笃)
笆	(巴|笆|芭)
笋	(筍|笋)
笑	(咲|笑)
笓	(篦|笓)
笔	(筆|笔)
笕	(筧|笕)
笛	(篴|笛)
笠	(笠|笠)
笨	(㤒|笨)
笶	(矢|笶)
笺	(箋|牋|笺)
笻	(筇|笻)
笼	(籠|笼|篭|籠)
笾	(籩|笾)
筆	(笔|筆)
筇	(笻|筇)
等	(朩|等)
筋	(觔|斤|筋)
筍	(笋|筍)
筏	(栰|筏)
筐	(筺|筐)
筑	(築|筑)
答	(荅|答)
策	(筞|策)
筚	(篳|筚)
筛	(篩|筛|簁|簛)
筜	(簹|筜)
筝	(箏|筝)
筞	(策|筞)
筦	(管|筦)
筧	(笕|筧)
筭	(算|祘|筭)
筯	(箸|筯)
筱	(篠|筱|筿)
筴	(䇲|筴)
筹	(籌|筹)
筺	(筐|筺)
筼	(篔|筼)
签	(簽|籤|签|籖)
筿	(篠|筱|筿)
简	(簡|简|耕|畊)
箇	(个|個|箇)
箋	(牋|笺|箋)
箍	(箛|箍)
箎	(篪|竾|箎)
箏	(筝|箏)
箒	(帚|箒|菷)
箓	(籙|箓)
箔	(泡|箔)
箖	(籃|箖|篮)
算	(祘|筭|算)
箚	(剳|札|劄|箚)
箛	(箍|箛)
箝	(鉗|钳|箝|鉆|鑽|鑚|钻)
箠	(捶|搥|箠)
管	(筦|管)
箦	(簀|箦)
箧	(篋|匧|箧)
箨	(籜|箨)
箩	(籮|箩)
箪	(簞|箪)
箫	(簫|燒|箫|箾|簘|烧|焼)
箬	(篛|箬)
箳	(簈|箳)
箴	(針|鍼|箴|针)
箸	(筯|箸)
箾	(簫|燒|箫|箾|簘|烧|焼)
節	(卩|罇|节|㔾|節|部|墫|樽)
範	(范|範)
築	(筑|築)
篋	(匧|箧|篋)
篑	(簣|篑|籄|蕢|蒉)
篓	(簍|篓)
篔	(筼|篔)
篘	(𥬠|篘)
篛	(箬|篛)
篠	(筱|筿|篠)
篡	(簒|篡)
篢	(槓|杠|篢)
篤	(笃|篤)
篦	(笓|篦)
篩	(筛|簁|簛|篩)
篪	(竾|箎|篪)
篭	(籠|笼|篭|籠)
篮	(籃|箖|篮)
篯	(籛|篯)
篱	(籬|篱)
篲	(彗|篲)
篳	(筚|篳)
篴	(笛|篴)
篺	(棑|篺)
簀	(箦|簀)
簁	(篩|簛|筛|簁)
簈	(箳|簈)
簌	(雝|廱|簌|𪪝|邕|雍)
簍	(篓|簍)
簑	(簔|蓑|簑)
簒	(篡|簒)
簔	(簑|簔|蓑)
簕	(竻|簕|𥵚)
簖	(籪|簖)
簘	(簫|燒|箫|箾|簘|烧|焼)
簛	(篩|簁|筛|簛)
簞	(箪|簞)
簠	(盙|簠)
簡	(简|耕|簡|畊)
簣	(篑|籄|蕢|簣|蒉)
簨	(栒|簨)
簫	(燒|箫|箾|簘|烧|焼|簫)
簷	(檐|簷)
簹	(筜|簹)
簻	(檛|簻)
簽	(签|簽|籤|籖)
簾	(帘|簾|𢅏|𢅖|簾|㡘)
籁	(籟|籁)
籃	(箖|篮|籃)
籄	(簣|蕢|篑|籄|蒉)
籋	(𥬞|籋)
籌	(筹|籌)
籐	(籘|藤|籐)
籑	(䉵|饌|籑|馔)
籔	(䉤|藪|籔|薮)
籖	(籤|签|籖|簽)
籘	(籐|籘|藤)
籙	(箓|籙)
籛	(篯|籛)
籜	(箨|籜)
籟	(籁|籟)
籠	(笼|篭|籠|籠)
籤	(签|籖|簽|籤)
籥	(龠|籥)
籩	(笾|籩)
籪	(簖|籪)
籬	(篱|籬)
籮	(箩|籮)
籲	(吁|龥|籲)
籴	(糴|籴)
类	(類|类|類|𩔗)
籼	(秈|籼)
粃	(秕|粃)
粋	(粹|粋)
粒	(粒|粒)
粗	(觕|麁|麄|麤|粗)
粘	(黏|粘)
粛	(肅|粛|肃)
粜	(糶|條|粜|条)
粝	(糲|粝)
粤	(粵|粤)
粥	(鬻|粥)
粦	(㷠|燐|粦|燐)
粧	(妝|妆|粧)
粪	(糞|粪)
粫	(糯|稬|穤|粫|𥻟)
粮	(糧|粮|糧)
粳	(秔|稉|粳)
粵	(粤|粵)
粹	(粋|粹)
粽	(糉|糭|粽)
精	(精|精)
糁	(糝|糁)
糇	(餱|糇)
糉	(粽|糭|糉)
糊	(胡|楜|糊|葫|蝴|衚|鬍)
糓	(穀|糓|谷)
糕	(餻|糕)
糖	(餹|糖|糖)
糙	(㿷|糙)
糝	(糁|糝)
糞	(粪|糞)
糟	(醩|糟)
糠	(穅|糠)
糡	(糨|糡)
糤	(饊|馓|糤)
糧	(粮|糧|糧)
糨	(糡|糨)
糭	(粽|糉|糭)
糯	(稬|穤|粫|𥻟|糯)
糰	(䊜|糰)
糲	(粝|糲)
糴	(籴|糴)
糶	(條|粜|条|糶)
糸	(糹|絲|糸|纟|丝)
糹	(糸|纟|糹|絲|丝)
糺	(糾|糺|纠)
系	(係|繫|系|繋)
糾	(糺|纠|糾)
紀	(纪|紀)
紂	(纣|紂)
約	(约|約)
紅	(红|紅)
紆	(纡|紆)
紇	(纥|紇)
紈	(纨|紈)
紉	(纫|紉)
紋	(纹|紋)
納	(纳|納)
紐	(纽|紐|紐)
紓	(纾|紓)
純	(纯|純)
紕	(纰|紕)
紖	(纼|紖)
紗	(纱|紗)
紘	(纮|紘)
紙	(帋|纸|紙)
級	(级|𨸚|級)
紛	(纷|紛)
紜	(纭|紜)
紝	(纴|紝)
紟	(衿|紟|襟)
紡	(纺|紡)
索	(索|索)
紥	(紮|扎|紥)
紧	(緊|紧|𦂳)
紬	(䌷|綢|紬|绸)
紮	(扎|紥|紮)
累	(纍|累|累)
細	(细|細)
紱	(绂|紱)
紲	(絏|緤|绁|紲)
紳	(绅|紳)
紵	(纻|紵)
紹	(佋|绍|紹)
紺	(绀|紺)
紼	(绋|紼)
紿	(绐|紿)
絀	(绌|絀)
終	(终|終)
絃	(弦|絃)
組	(组|組)
絅	(䌹|褧|絅)
絆	(绊|絆)
絋	(纊|絋|絖|纩)
経	(經|経|经|𦀇)
絎	(绗|絎)
絏	(紲|絏|緤|绁)
結	(揭|结|掲|結)
絕	(絶|绝|絕)
絖	(纊|絋|絖|纩)
絚	(緪|縆|絚)
絛	(縚|绦|絛)
絝	(绔|袴|褲|絝|綯|裤|绹)
絞	(绞|絞)
絡	(络|絡)
絢	(绚|絢)
絣	(背|絣)
絥	(鞴|絥)
給	(给|給)
絨	(绒|絨)
絪	(氤|絪)
絰	(绖|絰)
統	(綂|统|統)
絲	(丝|糸|纟|絲|糹)
絳	(绛|絳)
絵	(繪|絵|繢|绘|缋)
絶	(絕|絶|绝)
絷	(縶|絷)
絹	(绢|絹)
絺	(𫄨|絺)
綀	(𦈌|綀)
綁	(绑|綁)
綂	(統|綂|统)
綃	(绡|綃)
綆	(绠|綆)
綇	(𦈋|綇)
綈	(绨|綈)
綉	(繡|綉|繍|绣)
綌	(绤|綌)
綏	(绥|綏)
綐	(䌼|綐)
綑	(捆|綑)
經	(経|经|𦀇|經)
継	(繼|継|继)
続	(續|続|续)
綜	(综|綜)
綝	(𬘭|綝)
綞	(缍|綞)
綠	(氯|緑|绿|綠|綠)
綢	(紬|绸|䌷|綢)
綣	(绻|綣)
綫	(線|綫|线|缐)
綬	(绶|綬)
維	(维|維)
綯	(绹|褲|綯|絝|绔|袴|裤)
綰	(绾|綰)
綱	(纲|綱)
網	(网|㓁|網|罔)
綳	(繃|綳|绷)
綴	(缀|綴)
綵	(䌽|綵)
綸	(纶|綸)
綹	(绺|綹)
綺	(绮|綺)
綻	(䘺|绽|綻)
綽	(绰|綽)
綾	(绫|綾|綾)
綿	(緜|绵|綿)
緄	(绲|緄)
緇	(缁|緇)
緊	(紧|𦂳|緊)
緋	(绯|緋)
緍	(𦈏|緍)
総	(總|总|捴|搃|摠|総|縂|𢰾)
緐	(繁|緐)
緑	(綠|氯|緑|绿|綠)
緒	(緖|绪|緒)
緓	(绬|緓)
緔	(绱|緔|鞝)
緖	(緒|緖|绪)
緗	(缃|緗)
緘	(缄|緘)
緙	(缂|緙)
線	(綫|线|缐|線)
緜	(綿|緜|绵)
緝	(缉|緝)
緞	(缎|緞)
締	(缔|締)
緡	(眠|缗|緡)
緣	(縁|缘|緣)
緤	(紲|絏|緤|绁)
緥	(褓|緥|褴|襤|繿|襤|䍀)
緦	(缌|緦)
編	(编|編)
緩	(缓|緩)
緪	(絚|縆|緪)
緬	(缅|緬)
緯	(纬|緯)
緰	(𦈕|緰)
緱	(缑|緱)
緲	(眇|缈|緲)
練	(练|練|練)
緶	(缏|緶)
緷	(𦈉|緷)
緸	(𦈑|緸)
緹	(缇|緹)
緻	(致|緻)
緼	(縕|緼|缊|韞|韫)
縁	(緣|縁|缘)
縂	(總|总|捴|搃|摠|総|縂|𢰾)
縄	(繩|䋲|縄|绳)
縆	(絚|緪|縆)
縈	(萦|縈)
縉	(缙|縉)
縊	(缢|縊)
縋	(缒|縋)
縎	(𦈔|縎)
縐	(皺|绉|皱|縐)
縑	(缣|縑)
縕	(緼|缊|韞|縕|韫)
縗	(缞|縗)
縚	(絛|縚|绦)
縛	(缚|縛)
縝	(缜|縝)
縞	(缟|縞)
縟	(溽|缛|縟)
縣	(县|縣)
縦	(縱|縦|纵)
縫	(缝|縫)
縬	(𦈚|縬)
縭	(缡|褵|縭)
縮	(缩|縮)
縯	(䌥|縯|𦈠)
縱	(縦|纵|縱)
縲	(缧|縲)
縳	(䌸|縳)
縴	(纤|縴|纖|砌|繊|纎)
縵	(缦|縵)
縶	(絷|縶)
縷	(缕|縷|縷)
縹	(缥|縹)
縺	(𦈐|縺)
總	(总|捴|搃|摠|総|縂|𢰾|總)
績	(绩|績)
繁	(緐|繁)
繃	(綳|绷|繃)
繅	(繰|缫|繅|缲)
繆	(缪|繆)
繈	(繦|襁|繈)
繊	(纖|砌|繊|纎|纤|縴)
繋	(繫|系|繋|係)
繍	(繡|綉|繍|绣)
繏	(𦈝|繏)
繒	(缯|繒)
繓	(𦈛|繓)
織	(织|織)
繕	(缮|繕)
繖	(傘|伞|繖)
繙	(翻|繙|飜)
繚	(缭|繚)
繞	(绕|遶|繞)
繟	(𦈎|繟)
繡	(綉|繍|绣|繡)
繢	(繪|缋|絵|繢|绘)
繦	(繈|襁|繦)
繩	(䋲|縄|绳|繩)
繪	(絵|繢|绘|缋|繪)
繫	(系|繋|係|繫)
繭	(茧|繭)
繮	(缰|韁|繮)
繯	(缳|繯)
繰	(繅|缲|繰|缫)
繲	(挫|繲)
繳	(缴|繳)
繸	(䍁|繸)
繹	(绎|繹)
繻	(𦈡|繻)
繼	(継|继|繼)
繽	(缤|繽)
繾	(缱|繾)
繿	(䍀|襤|繿|褴|襤|褓|緥)
纁	(𫄸|纁)
纂	(臇|𤎱|纂)
纇	(颣|纇)
纈	(缬|纈)
纉	(纘|纉|缵)
纊	(絋|絖|纩|纊)
續	(続|续|續)
纍	(累|纍|累)
纎	(纖|砌|繊|纎|纤|縴)
纏	(纒|缠|纏)
纒	(纏|纒|缠)
纓	(缨|纓)
纔	(才|纔|財|㒲|财)
纖	(砌|繊|纎|纤|纖|縴)
纘	(纉|缵|纘)
纜	(䌫|缆|纜)
纟	(糹|絲|糸|纟|丝)
纠	(糾|糺|纠)
纡	(紆|纡)
红	(紅|红)
纣	(紂|纣)
纤	(縴|纖|纤|砌|繊|纎)
纥	(紇|纥)
约	(約|约)
级	(級|级|𨸚)
纨	(紈|纨)
纩	(纊|絋|絖|纩)
纪	(紀|纪)
纫	(紉|纫)
纬	(緯|纬)
纭	(紜|纭)
纮	(紘|纮)
纯	(純|纯)
纰	(紕|纰)
纱	(紗|纱)
纲	(綱|纲)
纳	(納|纳)
纴	(紝|纴)
纵	(縱|縦|纵)
纶	(綸|纶)
纷	(紛|纷)
纸	(紙|帋|纸)
纹	(紋|纹)
纺	(紡|纺)
纻	(紵|纻)
纼	(紖|纼)
纽	(紐|纽|紐)
纾	(紓|纾)
线	(線|綫|线|缐)
绀	(紺|绀)
绁	(紲|絏|緤|绁)
绂	(紱|绂)
练	(練|练|練)
组	(組|组)
绅	(紳|绅)
细	(細|细)
织	(織|织)
终	(終|终)
绉	(縐|皺|绉|皱)
绊	(絆|绊)
绋	(紼|绋)
绌	(絀|绌)
绍	(紹|佋|绍)
绎	(繹|绎)
经	(經|経|经|𦀇)
绐	(紿|绐)
绑	(綁|绑)
绒	(絨|绒)
结	(結|揭|结|掲)
绔	(絝|褲|绔|袴|綯|裤|绹)
绕	(繞|绕|遶)
绖	(絰|绖)
绗	(絎|绗)
绘	(繪|絵|繢|绘|缋)
给	(給|给)
绚	(絢|绚)
绛	(絳|绛)
络	(絡|络)
绝	(絕|絶|绝)
绞	(絞|绞)
统	(統|綂|统)
绠	(綆|绠)
绡	(綃|绡)
绢	(絹|绢)
绣	(繡|綉|繍|绣)
绤	(綌|绤)
绥	(綏|绥)
绦	(絛|縚|绦)
继	(繼|継|继)
绨	(綈|绨)
绩	(績|绩)
绪	(緒|緖|绪)
绫	(綾|绫|綾)
绬	(緓|绬)
续	(續|続|续)
绮	(綺|绮)
绯	(緋|绯)
绰	(綽|绰)
绱	(緔|鞝|绱)
绲	(緄|绲)
绳	(繩|䋲|縄|绳)
维	(維|维)
绵	(綿|緜|绵)
绶	(綬|绶)
绷	(繃|綳|绷)
绸	(綢|紬|绸|䌷)
绹	(綯|绹|褲|絝|绔|袴|裤)
绺	(綹|绺)
绻	(綣|绻)
综	(綜|综)
绽	(綻|䘺|绽)
绾	(綰|绾)
绿	(綠|氯|緑|绿|綠)
缀	(綴|缀)
缁	(緇|缁)
缂	(緙|缂)
缃	(緗|缃)
缄	(緘|缄)
缅	(緬|缅)
缆	(纜|䌫|缆)
缇	(緹|缇)
缈	(緲|眇|缈)
缉	(緝|缉)
缊	(縕|緼|缊|韞|韫)
缋	(繢|繪|缋|絵|绘)
缌	(緦|缌)
缍	(綞|缍)
缎	(緞|缎)
缏	(緶|缏)
缐	(線|綫|线|缐)
缑	(緱|缑)
缒	(縋|缒)
缓	(緩|缓)
缔	(締|缔)
缕	(縷|缕|縷)
编	(編|编)
缗	(緡|眠|缗)
缘	(緣|縁|缘)
缙	(縉|缙)
缚	(縛|缚)
缛	(縟|溽|缛)
缜	(縝|缜)
缝	(縫|缝)
缞	(縗|缞)
缟	(縞|缟)
缠	(纏|纒|缠)
缡	(縭|缡|褵)
缢	(縊|缢)
缣	(縑|缣)
缤	(繽|缤)
缥	(縹|缥)
缦	(縵|缦)
缧	(縲|缧)
缨	(纓|缨)
缩	(縮|缩)
缪	(繆|缪)
缫	(繅|繰|缫|缲)
缬	(纈|缬)
缭	(繚|缭)
缮	(繕|缮)
缯	(繒|缯)
缰	(繮|韁|缰)
缱	(繾|缱)
缲	(繰|繅|缲|缫)
缳	(繯|缳)
缴	(繳|缴)
缵	(纘|纉|缵)
缶	(缻|罐|缶|礶|鑵)
缷	(卸|缷)
缸	(堈|罁|缸)
缺	(欠|歉|缺)
缻	(缶|缻|罐|礶|鑵)
缽	(鉢|钵|缽)
缾	(瓶|甁|缾)
罁	(堈|缸|罁)
罂	(罌|甖|罂|罃)
罃	(甖|罌|罃|罂)
罅	(𨻲|罅)
罇	(墫|樽|節|罇|卩|节|㔾|部)
罈	(坛|墰|壜|壇|罈|傁|叟|叜)
罋	(瓮|甕|罋)
罌	(甖|罂|罃|罌)
罐	(礶|缶|鑵|罐|缻)
网	(㓁|網|罔|网)
罔	(网|㓁|網|罔)
罗	(囉|羅|啰|罗|羅)
罘	(罦|罘)
罚	(罰|罚|罸)
罢	(罷|罢)
罥	(羂|罥)
罦	(罘|罦)
罩	(䈇|罩)
罪	(辠|罪)
置	(寘|置)
罰	(罚|罸|罰)
署	(穎|署|頴|颖|颕)
罴	(羆|罴)
罵	(傌|駡|骂|罵)
罶	(羀|罶)
罷	(罢|罷)
罸	(罰|罚|罸)
罹	(罹|罹)
羀	(罶|羀)
羁	(羈|羁|羇|覉|覊)
羂	(罥|羂)
羃	(冪|幂|羃|鼏)
羅	(罗|羅|囉|羅|啰)
羆	(罴|羆)
羇	(羈|羁|羇|覉|覊)
羈	(羁|羇|覉|覊|羈)
羋	(芈|羋)
羌	(羗|羌)
美	(羙|美)
羓	(豝|羓)
羖	(𦍩|羖)
羗	(羌|羗)
羙	(美|羙)
羚	(羚|羚)
羝	(牴|羝|觝)
羟	(羥|羟)
羡	(羨|羡)
羣	(群|羣)
群	(羣|群)
羥	(羟|羥)
羨	(羡|羨)
義	(义|義)
羮	(羹|羮)
羴	(羶|羴|膻)
羶	(羴|膻|羶)
羹	(羮|羹)
羽	(羽|羽)
翄	(翅|翄)
翅	(翄|翅)
翆	(翠|翆)
習	(习|習)
翘	(翹|翘)
翙	(翽|翙)
翚	(翬|翚)
翠	(翆|翠)
翥	(䬡|翥)
翦	(剪|翦)
翬	(翚|翬)
翱	(翶|翺|翱)
翶	(翱|翶|翺)
翹	(翘|翹)
翺	(翱|翶|翺)
翻	(繙|飜|翻)
翼	(折|拃|翼)
翽	(翙|翽)
耀	(曜|燿|耀)
老	(耂|老|老)
耂	(老|耂|老)
考	(攷|考)
耇	(耈|耇|耉)
耈	(耇|耉|耈)
耉	(耈|耇|耉)
耏	(耐|耏)
耐	(耏|耐)
耑	(專|专|専|耑)
耒	(來|徠|来|耒|來|倈|勑|徕|俫|勅|敕)
耔	(秄|耔)
耕	(畊|簡|耕|简)
耗	(秏|耗)
耘	(秐|耘)
耙	(鈀|耙|钯)
耡	(鋤|耡|鉏|锄)
耢	(耮|耢)
耤	(藉|借|耤)
耧	(耬|耧)
耨	(鎒|耨)
耬	(耧|耬)
耮	(耢|耮)
耰	(櫌|耰)
耸	(聳|耸)
耻	(恥|耻)
耼	(聃|耼)
耽	(躭|眈|耽)
耿	(炅|炔|耿)
聂	(聶|聂)
聃	(耼|聃)
聆	(聆|聆)
聋	(聾|聋|聾)
职	(職|职|軄)
聍	(聹|聍)
联	(聯|联|聨|聫|聮|聯)
聖	(圣|垩|堊|聖)
聝	(馘|聝)
聞	(闻|聞)
聟	(婿|壻|聟)
聡	(聰|聡|聦|聪)
聦	(聰|聡|聦|聪)
聨	(聯|联|聨|聫|聮|聯)
聩	(聵|聩)
聪	(聰|聡|聦|聪)
聫	(聯|联|聨|聫|聮|聯)
聮	(聯|联|聨|聫|聮|聯)
聯	(联|聨|聫|聮|聯|聯)
聰	(聡|聦|聪|聰)
聲	(声|聲)
聳	(耸|聳)
聴	(聽|听|聴|聼)
聵	(聩|聵)
聶	(聂|聶)
職	(职|軄|職)
聹	(聍|聹)
聻	(魙|聻)
聼	(聽|听|聴|聼)
聽	(听|聴|聼|聽)
聾	(聋|聾|聾)
聿	(肀|聿)
肀	(聿|肀)
肃	(肅|粛|肃)
肅	(粛|肃|肅)
肆	(四|肆)
肇	(肈|肇)
肈	(肇|肈)
肉	(宍|肉)
肋	(肋|肋)
肐	(胳|𩨘|肐)
肕	(韌|肕|靭|靱|韧)
肠	(腸|肠|膓)
股	(脵|𦙶|股)
肢	(胑|肢)
肤	(膚|肤)
肧	(胚|肧)
肨	(胮|肨)
肬	(疣|肬)
肮	(骯|肮|腌|醃)
肯	(肻|肯)
肱	(厷|肱)
育	(毓|育)
肳	(吻|呡|肳)
肴	(餚|肴)
肻	(肯|肻)
肾	(腎|肾)
肿	(腫|尰|肿)
胀	(脹|痮|胀)
胁	(脅|勰|胁|脇|協|恊|协|旪)
胄	(伷|冑|咮|胄)
胆	(膽|胆)
胊	(朐|胊|鴝|鸜|鸲)
背	(絣|背)
胑	(肢|胑)
胓	(𦚓|胓)
胔	(骴|胔|𦙼)
胗	(疹|胗)
胚	(肧|胚)
胜	(勝|胜)
胝	(郅|胝)
胞	(脬|胞)
胡	(楜|糊|葫|蝴|衚|鬍|胡)
胧	(朧|矓|胧|眬)
胨	(腖|胨)
胪	(臚|胪|髗|顱|颅)
胫	(脛|胫)
胭	(臙|胭)
胮	(肨|胮)
胯	(骻|胯)
胳	(肐|𩨘|胳)
胶	(膠|胶)
胷	(匈|胸|胷)
胸	(匈|胷|胸)
胼	(腁|胼)
脃	(脆|脃)
脅	(勰|胁|脇|協|恊|脅|协|旪)
脆	(脃|脆)
脇	(脅|勰|胁|脇|協|恊|协|旪)
脈	(脉|衇|䘑|脈)
脉	(䘑|脈|衇|脉)
脍	(膾|脍|鱠|鲙)
脏	(臟|髒|脏|臓)
脐	(臍|脐)
脑	(腦|匘|脑|脳)
脓	(膿|脓)
脔	(臠|脔)
脚	(腳|脚)
脛	(胫|脛)
脣	(唇|脣)
脥	(𣍰|脥)
脧	(朘|脧)
脪	(㾙|脪)
脫	(脱|脫)
脬	(胞|脬)
脱	(脫|脱)
脲	(尿|氽|溺|脲|尿|氼|溺)
脳	(腦|匘|脑|脳)
脵	(股|脵|𦙶)
脶	(腡|脶)
脸	(臉|脸)
脹	(痮|胀|脹)
腁	(胼|腁)
腊	(臈|臘|腊|臘)
腌	(醃|骯|腌|肮)
腎	(肾|腎)
腕	(𦙵|腕)
腖	(胨|腖)
腘	(膕|腘)
腟	(膣|腟)
腡	(脶|腡)
腢	(髃|腢)
腦	(匘|脑|脳|腦)
腪	(𣍯|腪)
腫	(尰|肿|腫)
腭	(齶|腭)
腮	(顋|腮)
腳	(脚|腳)
腸	(肠|膓|腸)
腻	(膩|腻)
腼	(靦|腼|覥|觍)
腽	(膃|腽)
腾	(騰|腾|駦)
腿	(骽|腿)
膃	(腽|膃)
膆	(嗉|膆)
膋	(膫|膋)
膑	(臏|膑|髌|髕)
膓	(腸|肠|膓)
膕	(腘|膕)
膘	(臕|膘)
膚	(肤|膚)
膠	(胶|膠)
膢	(𦝼|膢)
膣	(腟|膣)
膩	(腻|膩)
膫	(膋|膫)
膳	(饍|膳)
膸	(髓|膸|髄)
膻	(羶|羴|膻)
膽	(胆|膽)
膾	(脍|鱠|膾|鲙)
膿	(脓|膿)
臇	(纂|𤎱|臇)
臈	(腊|臘|臈|臘)
臉	(脸|臉)
臊	(𦞣|臊)
臍	(脐|臍)
臏	(膑|髌|髕|臏)
臓	(臟|脏|臓|髒)
臕	(膘|臕)
臗	(𣎑|臗)
臘	(腊|臈|臘|臘)
臙	(胭|臙)
臚	(胪|髗|臚|顱|颅)
臜	(臢|臜)
臞	(癯|臞)
臟	(脏|臓|臟|髒)
臠	(脔|臠)
臢	(臜|臢)
臥	(卧|臥)
臨	(临|臨|臨)
臯	(皋|𦤎|皐|睾|臯)
致	(緻|致)
臺	(台|檯|臺|颱|儓|枱)
舀	(外|抌|舀)
舃	(舄|舃)
舄	(舃|舄)
舆	(輿|舆|轝)
與	(与|與)
興	(㒷|兴|興)
舉	(㪯|举|挙|擧|舉)
舊	(旧|舊)
舍	(捨|舎|舍)
舎	(舍|捨|舎)
舐	(舓|舐)
舒	(摴|舒)
舓	(舐|舓)
舔	(餂|舔)
舖	(鋪|舖|舗|铺)
舗	(鋪|舖|舗|铺)
舘	(館|舘|馆|館)
舡	(船|舡|舩)
舣	(艤|舣)
舦	(艜|舦)
舩	(船|舡|舩)
航	(桁|航)
舮	(櫓|㯭|樐|橹|舮|舻|艣|艪|艫|櫓)
舰	(艦|舰)
舱	(艙|舱)
舵	(柁|舵)
舶	(艊|舶)
船	(舡|舩|船)
舻	(櫓|艫|㯭|樐|橹|舮|舻|艣|艪|櫓)
艊	(舶|艊)
艑	(扁|碥|艑)
艙	(舱|艙)
艜	(舦|艜)
艢	(檣|樯|艢)
艣	(櫓|㯭|樐|橹|舮|舻|艣|艪|艫|櫓)
艤	(舣|艤)
艥	(楫|檝|艥)
艦	(舰|艦)
艪	(樐|櫓|㯭|艪|橹|舮|舻|艣|艫|櫓)
艫	(櫓|舻|㯭|樐|橹|舮|艣|艪|艫|櫓)
良	(良|良)
艰	(艱|艰)
艱	(艰|艱)
艳	(艷|豔|艳|艶|豓)
艴	(勃|艴)
艶	(豓|豔|艶|艳|艷)
艷	(艳|豔|艷|艶|豓)
艸	(艹|草|艸)
艹	(艸|草|艹)
艺	(藝|兿|埶|秇|艺|芸|蓺|蕓)
艽	(韭|艽|韮)
节	(節|卩|罇|节|㔾|部|墫|樽)
芈	(羋|芈)
芊	(茜|芊)
芒	(杧|芒)
芔	(卉|芔)
芗	(薌|芗)
芘	(蓖|蔽|芘|萆|菝)
芜	(蕪|芜)
芟	(𠚹|芟)
芦	(蘆|芦|蘆)
芭	(巴|笆|芭)
花	(蘤|花)
芸	(蕓|藝|芸|兿|埶|秇|艺|蓺)
芻	(刍|蒭|𦷝|芻)
苁	(蓯|苁)
苅	(刈|苅)
苇	(葦|苇)
苈	(藶|苈)
苋	(莧|苋)
苌	(萇|苌)
苍	(蒼|苍)
苎	(苧|蒙|苎|薴|懞|朦|矇)
苏	(蘇|囌|苏|蘓)
苑	(菀|苑)
苕	(䒒|苕)
苛	(哼|苛)
苟	(茍|苟)
苡	(苢|苡)
苢	(苡|苢)
苤	(瞥|苤)
若	(若|若)
苧	(苎|薴|苧|蒙|懞|朦|矇)
苹	(蘋|苹)
苺	(莓|苺)
苽	(菇|菰|苽|𦱄)
苿	(菋|苿)
茂	(楙|茂)
范	(範|范)
茅	(泖|茆|茅)
茆	(茅|泖|茆)
茈	(柴|茈)
茍	(苟|茍)
茎	(莖|茎)
茏	(蘢|茏)
茑	(蔦|茑)
茔	(塋|茔)
茕	(煢|焭|茕)
茘	(荔|栛|茘)
茜	(芊|茜)
茠	(薅|茠)
茧	(繭|茧)
茭	(椒|茭)
茲	(兹|玆|茲)
茶	(茶|茶)
荅	(答|荅)
荆	(荊|荆)
荇	(莕|荇)
草	(艸|艹|草)
荊	(荆|荊)
荍	(蕎|荍|荞)
荐	(薦|荐)
荔	(栛|茘|荔)
荘	(莊|庄|荘)
荙	(薘|荙)
荚	(莢|荚)
荛	(蕘|荛)
荜	(蓽|荜)
荝	(萴|荝)
荞	(蕎|荍|荞)
荟	(薈|荟)
荠	(薺|荠|萕)
荡	(盪|蕩|荡|蘯|逿|𨌩|偒)
荣	(榮|栄|荣)
荤	(葷|荤)
荥	(滎|荥)
荦	(犖|荦)
荧	(熒|荧)
荨	(蕁|荨)
荩	(藎|荩)
荪	(蓀|荪)
荫	(蔭|廕|荫)
荬	(蕒|荬)
荭	(葒|荭)
荮	(葤|荮)
药	(藥|药|葯|薬)
荳	(豆|荳)
荽	(萎|荽)
莀	(農|农|莀)
莅	(涖|蒞|莅|𦲷)
莆	(蒲|莆)
莊	(庄|荘|莊)
莓	(苺|莓)
莕	(荇|莕)
莖	(茎|莖)
莜	(蓧|莜)
莢	(荚|莢)
莧	(苋|莧)
莩	(殍|莩)
莱	(萊|莱)
莲	(蓮|莲|蓮)
莳	(蒔|莳)
莴	(萵|莴)
莵	(菟|莵)
莶	(薟|莶|蘞|蔹)
获	(獲|穫|获|檴)
莸	(蕕|莸)
莹	(瑩|莹|瑩)
莺	(鶯|莺|鴬|鸎)
莼	(蒓|蓴|莼)
莿	(刺|朿|刾|莿|刺|㓨)
菀	(苑|菀)
菇	(苽|菰|𦱄|菇)
菉	(菉|菉)
菋	(苿|菋)
菌	(滾|蕈|滚|菌)
菑	(災|灾|烖|甾|菑)
菓	(果|菓)
菔	(蔔|菔)
菝	(蔽|芘|菝|萆|蓖)
菟	(莵|菟)
菢	(勽|㲒|菢)
菫	(堇|菫)
華	(华|崋|蕐|華)
菰	(苽|菇|菰|𦱄)
菱	(菱|菱)
菴	(庵|菴)
菷	(帚|箒|菷)
菸	(烟|煙|完|菸)
菻	(麻|菻|蔴)
萅	(春|萅)
萆	(蓖|蔽|芘|萆|菝)
萇	(苌|萇)
萊	(莱|萊)
萌	(萠|萌)
萎	(荽|萎)
萕	(薺|荠|萕)
萚	(蘀|萚)
萝	(蘿|萝|蘿)
萠	(萌|萠)
萤	(螢|萤|蛍)
营	(營|営|营)
萦	(縈|萦)
萧	(蕭|萧)
萨	(薩|萨)
萬	(万|卍|萬|卐)
萱	(萲|萱)
萲	(萱|萲)
萴	(荝|萴)
萵	(莴|萵)
萼	(蕚|萼)
落	(落|落)
葁	(薑|姜|葁)
葉	(叶|葉|葉)
葒	(荭|葒)
著	(着|螫|著)
葚	(椹|葚)
葢	(盖|蓋|葢)
葤	(荮|葤)
葦	(苇|葦)
葫	(胡|楜|糊|葫|蝴|衚|鬍)
葬	(塟|葬)
葯	(藥|药|葯|薬)
葱	(蔥|葱)
葷	(荤|葷)
蒇	(蕆|蒇)
蒉	(蕢|簣|籄|蒉|篑)
蒋	(蔣|蒋)
蒌	(蔞|蒌|褸|褛)
蒍	(蔿|蒍)
蒓	(莼|蓴|蒓)
蒔	(莳|蒔)
蒙	(懞|朦|矇|苎|蒙|苧|薴)
蒞	(涖|莅|𦲷|蒞)
蒭	(芻|刍|蒭|𦷝)
蒲	(莆|蒲)
蒸	(烝|蒸)
蒼	(苍|蒼)
蓀	(荪|蓀)
蓆	(席|蓆)
蓋	(盖|葢|蓋)
蓑	(簑|簔|蓑)
蓖	(芘|萆|蓖|蔽|菝)
蓝	(藍|蓝|藍)
蓟	(薊|蓟)
蓠	(蘺|蓠)
蓡	(參|叁|参|叄|叅|蓡|薓|參|三)
蓣	(蕷|蓣)
蓥	(鎣|蓥)
蓦	(驀|蓦)
蓧	(莜|蓧)
蓮	(莲|蓮|蓮)
蓯	(苁|蓯)
蓴	(莼|蒓|蓴)
蓺	(埶|秇|藝|蓺|兿|艺|芸|蕓)
蓼	(蓼|蓼)
蓽	(荜|蓽)
蔂	(虆|蔂)
蔔	(菔|蔔)
蔗	(𧀹|蔗)
蔚	(嶎|蔚)
蔞	(蒌|褸|蔞|褛)
蔣	(蒋|蔣)
蔥	(葱|蔥)
蔦	(茑|蔦)
蔭	(廕|荫|蔭)
蔴	(麻|菻|蔴)
蔵	(藏|蔵)
蔷	(薔|蔷)
蔹	(蘞|蔹|薟|莶)
蔺	(藺|蔺|藺)
蔼	(藹|蔼)
蔽	(芘|菝|萆|蓖|蔽)
蔿	(蒍|蔿)
蕁	(荨|蕁)
蕆	(蒇|蕆)
蕈	(菌|滾|蕈|滚)
蕊	(蕋|蘂|蕊)
蕋	(蕊|蕋|蘂)
蕎	(荍|荞|蕎)
蕐	(華|华|崋|蕐)
蕒	(荬|蕒)
蕓	(芸|蕓|藝|兿|埶|秇|艺|蓺)
蕕	(莸|蕕)
蕘	(荛|蕘)
蕚	(萼|蕚)
蕢	(簣|籄|蒉|篑|蕢)
蕣	(橓|蕣)
蕤	(甤|蕤)
蕩	(偒|盪|荡|蘯|蕩|逿|𨌩)
蕪	(芜|蕪)
蕭	(萧|蕭)
蕰	(薀|蕰)
蕲	(蘄|蕲)
蕴	(蘊|蕴|藴)
蕷	(蓣|蕷)
薀	(蕰|薀)
薅	(茠|薅)
薈	(荟|薈)
薊	(蓟|薊)
薌	(芗|薌)
薑	(姜|葁|薑)
薓	(參|叁|参|叄|叅|蓡|薓|參|三)
薔	(蔷|薔)
薘	(荙|薘)
薟	(莶|蘞|薟|蔹)
薦	(荐|薦)
薩	(萨|薩)
薫	(薰|薫)
薬	(藥|药|葯|薬)
薮	(藪|籔|薮|䉤)
薯	(藷|薯)
薰	(薫|薰)
薳	(䓕|薳)
薴	(苧|苎|薴|蒙|懞|朦|矇)
薺	(荠|萕|薺)
藇	(𨣦|藇)
藉	(借|耤|藉)
藍	(蓝|藍|藍)
藎	(荩|藎)
藏	(蔵|藏)
藓	(蘚|藓)
藝	(兿|埶|秇|艺|芸|蓺|藝|蕓)
藟	(蘽|藟)
藤	(籐|籘|藤)
藥	(药|葯|薬|藥)
藦	(蘑|藦)
藪	(籔|薮|䉤|藪)
藴	(蘊|蕴|藴)
藶	(苈|藶)
藷	(薯|藷)
藹	(蔼|藹)
藺	(蔺|藺|藺)
蘀	(萚|蘀)
蘂	(蕊|蕋|蘂)
蘄	(蕲|蘄)
蘆	(芦|蘆|蘆)
蘇	(囌|苏|蘓|蘇)
蘊	(蕴|藴|蘊)
蘋	(苹|蘋)
蘏	(蘔|蘏)
蘑	(藦|蘑)
蘒	(蘒|蘒)
蘓	(蘇|囌|苏|蘓)
蘔	(蘏|蘔)
蘖	(櫱|蘗|蘖|檘)
蘗	(檘|蘖|蘗|櫱)
蘚	(藓|蘚)
蘞	(蔹|薟|蘞|莶)
蘢	(茏|蘢)
蘤	(花|蘤)
蘭	(兰|蘭|蘭)
蘯	(盪|蕩|荡|蘯|逿|𨌩|偒)
蘺	(蓠|蘺)
蘽	(藟|蘽)
蘿	(萝|蘿|蘿)
虆	(蔂|虆)
虎	(乕|虎)
虏	(虜|擄|虏|虜|掳|擄)
虐	(䖈|乇|虐)
虑	(慮|虑)
虓	(唬|猇|虓|諕)
虔	(䖍|虔)
處	(䖏|処|嗻|处|處)
虖	(呼|嘑|虖|謼)
虚	(虛|虚)
虛	(虚|虛)
虜	(擄|虏|虜|掳|虜|擄)
虞	(𩦢|虞)
號	(号|號)
虣	(暴|虣|暴)
虧	(亏|扵|於|虧|于)
虫	(蟲|虫)
虬	(虯|蚪|虬)
虮	(蟣|虮)
虯	(虬|虯|蚪)
虱	(蝨|虱)
虺	(蝰|虺)
虽	(雖|虽)
虾	(蝦|虾|鰕)
虿	(蠆|虿)
蚀	(蝕|蚀)
蚁	(蟻|蚁|螘)
蚂	(螞|蚂)
蚃	(蠁|蚃)
蚊	(螡|蟁|蚊)
蚋	(蜹|蚋)
蚓	(螾|蚓)
蚕	(蠶|蚕)
蚘	(痐|蛔|蛕|蚘|蜖)
蚝	(螆|蚝|蛓)
蚤	(䖣|蚤)
蚦	(蚺|蚦)
蚪	(虬|虯|蚪)
蚬	(蜆|蚬)
蚺	(蚦|蚺)
蛄	(蛌|蛄)
蛆	(𧐅|蛆)
蛊	(蠱|蛊)
蛋	(旦|疍|蜑|蛋)
蛌	(蛄|蛌)
蛍	(螢|萤|蛍)
蛎	(蠣|蛎)
蛏	(蟶|蛏)
蛓	(螆|蚝|蛓)
蛔	(蚘|蛕|蜖|痐|蛔)
蛕	(蚘|蛔|痐|蛕|蜖)
蛗	(𧌓|蛗)
蛙	(鼃|蛙)
蛛	(鼄|蛛)
蛮	(蠻|蛮)
蛰	(蟄|蛰)
蛱	(蛺|蛱)
蛲	(蟯|蛲)
蛳	(螄|蛳)
蛴	(蠐|蛴)
蛺	(蛱|蛺)
蛻	(蜕|蛻)
蜂	(蠭|蜂)
蜆	(蚬|蜆)
蜇	(𧋍|蜇)
蜋	(螂|蜋)
蜍	(蠩|蜍)
蜑	(蛋|旦|疍|蜑)
蜕	(蛻|蜕)
蜖	(蛔|蚘|蛕|蜖|痐)
蜗	(蝸|蜗)
蜘	(鼅|蜘)
蜝	(蜞|蜝)
蜞	(蜝|蜞)
蜡	(䄍|蜡|蠟|蝋|蠟)
蜨	(蝶|蜨)
蜫	(䖵|蜫)
蜱	(螵|蜱)
蜶	(蟀|蜶)
蜹	(蚋|蜹)
蜺	(霓|蜺)
蝃	(螮|䗖|蝃)
蝇	(蠅|蝇|蝿)
蝈	(蟈|蝈)
蝉	(蟬|蝉)
蝋	(蠟|蜡|蝋|蠟|䄍)
蝎	(蠍|蝎)
蝕	(蚀|蝕)
蝟	(猬|蝟)
蝥	(蟊|蝥)
蝦	(虾|鰕|蝦)
蝨	(虱|蝨)
蝯	(猨|猿|蝯)
蝰	(虺|蝰)
蝱	(䖟|蝱)
蝴	(胡|楜|糊|葫|蝴|衚|鬍)
蝶	(蜨|蝶)
蝸	(蜗|蝸)
蝼	(螻|蝼)
蝾	(蠑|蝾)
蝿	(蠅|蝇|蝿)
螀	(螿|螀)
螂	(蜋|螂)
螄	(蛳|螄)
螆	(蚝|蛓|螆)
融	(螎|融)
螎	(融|螎)
螗	(螳|螗)
螘	(蟻|蚁|螘)
螙	(蠧|螙|蠹)
螞	(蚂|螞)
螡	(蚊|螡|蟁)
螢	(萤|蛍|螢)
螨	(蟎|螨)
螫	(著|着|螫)
螮	(䗖|蝃|螮)
螳	(螗|螳)
螵	(蜱|螵)
螺	(蠃|螺|螺)
螻	(蝼|螻)
螾	(蚓|螾)
螿	(螀|螿)
蟀	(蜶|蟀)
蟁	(蚊|螡|蟁)
蟄	(蛰|蟄)
蟆	(蟇|蟆)
蟇	(蟆|蟇)
蟈	(蝈|蟈)
蟊	(蝥|蟊)
蟎	(螨|蟎)
蟏	(蠨|蟏)
蟒	(蠎|蟒)
蟚	(蟛|蟚)
蟛	(蟚|蟛)
蟣	(虮|蟣)
蟬	(蝉|蟬)
蟮	(蟺|蟮)
蟯	(蛲|蟯)
蟲	(虫|蟲)
蟶	(蛏|蟶)
蟹	(蠏|蟹)
蟺	(蟮|蟺)
蟻	(蚁|螘|蟻)
蠁	(蚃|蠁)
蠃	(螺|蠃|螺)
蠅	(蝇|蝿|蠅)
蠆	(虿|蠆)
蠍	(蝎|蠍)
蠎	(蟒|蠎)
蠏	(蟹|蠏)
蠐	(蛴|蠐)
蠑	(蝾|蠑)
蠔	(𧐢|蠔)
蠟	(蜡|蝋|蠟|䄍|蠟)
蠢	(惷|蠢)
蠣	(蛎|蠣)
蠧	(螙|蠹|蠧)
蠨	(蟏|蠨)
蠩	(蜍|蠩)
蠭	(蜂|蠭)
蠱	(蛊|蠱)
蠶	(蚕|蠶)
蠹	(蠧|螙|蠹)
蠻	(蛮|蠻)
衂	(衄|衂)
衄	(衂|衄)
衅	(釁|衅)
衆	(眾|𠂝|众|衆)
衇	(脈|脉|衇|䘑)
行	(行|行)
衒	(炫|衒)
術	(术|術)
衔	(銜|㘅|衔|啣)
衕	(同|仝|衕)
街	(亍|街)
衚	(胡|楜|糊|葫|蝴|衚|鬍)
衛	(卫|衞|衛)
衝	(冲|𧘂|沖|衝|盅)
衞	(衛|卫|衞)
衣	(衤|衣)
衤	(衣|衤)
补	(補|补)
表	(錶|表)
衬	(襯|儭|衬)
衮	(袞|衮)
衽	(袵|衽)
衿	(紟|襟|衿)
袄	(襖|澳|袄|𥜌)
袅	(嬝|裊|嫋|袅)
袆	(褘|袆)
袋	(帒|袋)
袒	(襢|袒)
袖	(褎|袖|褏)
袜	(襪|袜|韈|韤)
袞	(衮|袞)
袠	(帙|袠)
袭	(襲|袭)
袮	(你|妳|您|祢|伱|伲|袮|奶|嬭|禰)
袯	(襏|袯)
袴	(絝|褲|绔|袴|綯|裤|绹)
袵	(衽|袵)
袷	(裌|袷)
裂	(裂|裂)
装	(裝|装)
裆	(襠|裆)
裈	(褌|裈)
裉	(褃|裉)
裊	(嬝|袅|嫋|裊)
裌	(袷|裌)
裏	(裡|里|裏|裡|里|裏)
裒	(鴄|裒)
裙	(帬|裠|裙)
補	(补|補)
裝	(装|裝)
裠	(裙|帬|裠)
裡	(裏|里|裡|裏|裡|里)
裢	(褳|裢)
裣	(襝|裣|襜|輦|辇|輦)
裤	(褲|絝|綯|绔|袴|裤|绹)
裥	(襉|裥)
裴	(裵|裴)
裵	(裴|裵)
裸	(躶|裸|裸)
製	(制|製)
褃	(裉|褃)
複	(复|復|複|覆|復)
褌	(裈|褌)
褎	(袖|褏|褎)
褏	(褎|袖|褏)
褒	(襃|褒)
褓	(緥|褴|褓|襤|繿|襤|䍀)
褘	(袆|褘)
褛	(褸|蔞|褛|蒌)
褟	(溻|褟)
褢	(褱|褢)
褧	(絅|䌹|褧)
褱	(褢|褱)
褲	(絝|綯|绔|袴|裤|褲|绹)
褳	(裢|褳)
褴	(褓|襤|緥|褴|繿|襤|䍀)
褵	(縭|缡|褵)
褸	(蔞|褛|蒌|褸)
褺	(䙝|褻|褺|亵)
褻	(䙝|亵|褺|褻)
襀	(𫌀|襀)
襁	(繈|繦|襁)
襃	(褒|襃)
襄	(㐮|襄)
襉	(裥|襉)
襍	(雜|杂|襍|雑)
襏	(袯|襏)
襕	(襴|幱|襕)
襖	(澳|袄|𥜌|襖)
襜	(襝|輦|裣|襜|辇|輦)
襝	(裣|襜|襝|輦|辇|輦)
襟	(衿|紟|襟)
襠	(裆|襠)
襢	(袒|襢)
襤	(繿|褴|襤|䍀|襤|褓|緥)
襪	(袜|韈|韤|襪)
襬	(䙓|襬)
襮	(幞|襮)
襯	(儭|衬|襯)
襲	(袭|襲)
襴	(幱|襕|襴)
襾	(西|襾|覀)
西	(襾|覀|西)
覀	(西|襾|覀)
覆	(复|復|複|覆|復)
覇	(霸|覇)
覈	(核|槅|覈)
覉	(羈|羁|羇|覉|覊)
覊	(羈|羁|羇|覉|覊)
見	(见|見|見)
覌	(觀|覌|観|观)
覎	(觃|覎)
規	(槻|规|規)
覐	(覺|斍|覐|覚|觉)
覓	(覔|觅|覓)
覔	(覓|覔|觅)
視	(眎|视|視)
覘	(䦓|觇|𦕒|覘)
覙	(覼|覙|𫌨)
覚	(覺|斍|覐|覚|觉)
覡	(觋|覡)
覥	(觍|靦|覥|腼)
覦	(觎|覦)
覧	(覽|覧|览)
覩	(睹|覩)
親	(亲|榛|親)
覬	(觊|覬)
覯	(觏|覯)
覰	(覷|覰|觑)
覲	(觐|覲)
観	(觀|覌|観|观)
覵	(覸|覵)
覷	(覰|觑|覷)
覸	(覵|覸)
覺	(斍|覐|覚|觉|覺)
覼	(覙|𫌨|覼)
覽	(覧|览|覽)
覿	(觌|覿)
觀	(覌|観|观|觀)
见	(見|见|見)
观	(觀|覌|観|观)
觃	(覎|觃)
规	(規|槻|规)
觅	(覓|覔|觅)
视	(視|眎|视)
觇	(覘|䦓|觇|𦕒)
览	(覽|覧|览)
觉	(覺|斍|覐|覚|觉)
觊	(覬|觊)
觋	(覡|觋)
觌	(覿|觌)
觍	(覥|觍|靦|腼)
觎	(覦|觎)
觏	(覯|觏)
觐	(覲|觐)
觑	(覷|覰|觑)
角	(甪|角)
觔	(斤|筋|觔)
觕	(粗|麄|麤|觕|麁)
觜	(咀|嘴|觜)
觝	(牴|羝|觝)
觞	(觴|觞)
解	(觧|解)
觥	(觵|觥)
触	(觸|触)
觧	(解|觧)
觯	(觶|觯)
觴	(觞|觴)
觵	(觥|觵)
觶	(觯|觶)
觸	(触|觸)
言	(訁|讠|言)
訁	(言|讠|訁)
訂	(订|訂)
訃	(讣|訃)
訇	(渹|𢕐|𥔀|訇)
計	(计|計)
訊	(讯|訊)
訌	(讧|訌)
討	(讨|討)
訐	(讦|訐)
訑	(𫍙|訑)
訒	(讱|訒)
訓	(训|訓)
訕	(讪|訕)
訖	(讫|訖)
託	(侂|讬|託)
記	(记|記)
訚	(誾|訚)
訛	(譌|讹|訛)
訝	(讶|訝)
訟	(讼|訟)
訠	(矧|訠)
訢	(䜣|訢)
訣	(诀|訣)
訥	(吶|讷|呐|訥)
訦	(諶|訦|谌)
訩	(詾|讻|訩)
訪	(访|訪)
設	(设|設)
許	(许|許)
訳	(譯|訳|译)
訴	(愬|诉|訴)
訶	(呵|诃|嗬|訶)
診	(诊|診)
註	(注|註)
証	(證|証|证)
訽	(詬|呴|訽|诟)
詀	(𧮪|詀)
詁	(诂|詁)
詆	(诋|詆)
詋	(呪|咒|詋)
詎	(讵|詎)
詐	(诈|醡|詐|榨|酢|醋)
詑	(𫍟|詑)
詒	(诒|詒)
詔	(诏|詔)
評	(评|評)
詖	(诐|詖)
詗	(诇|詗)
詘	(诎|詘)
詛	(诅|詛)
詞	(词|詞)
詟	(讋|詟)
詠	(咏|詠)
詡	(诩|詡)
詢	(询|詢)
詣	(诣|詣)
詤	(謊|詤|谎)
試	(试|試)
詧	(察|詧)
詩	(诗|詩)
詫	(诧|詫)
詬	(呴|訽|诟|詬)
詭	(诡|詭)
詮	(诠|詮)
詰	(诘|詰)
話	(䛡|话|話)
該	(该|該)
詳	(详|詳)
詵	(侁|诜|駪|詵)
詶	(酬|詶|酧|醻)
詻	(咯|詻)
詼	(诙|詼)
詾	(訩|詾|讻)
詿	(诖|詿)
誄	(诔|誄)
誅	(诛|誅)
誆	(诓|誆)
誇	(侉|夸|誇)
誉	(譽|域|誉|㽣)
誊	(謄|誊)
誌	(志|誌)
認	(认|認)
誐	(哦|誐)
誑	(诳|誑)
誒	(唉|诶|欸|誒)
誕	(诞|𧩙|誕|䜥)
誘	(䛻|诱|誘)
誚	(譙|诮|誚|谯)
語	(语|語)
誠	(诚|誠)
誡	(诫|誡)
誣	(诬|誣)
誤	(悞|误|悮|誤)
誥	(诰|誥)
誦	(诵|誦)
誨	(诲|誨)
誩	(競|竞|竸|誩)
說	(説|说|說|說|說)
説	(說|説|说|說|說)
読	(讀|読|读|讀)
誰	(谁|誰)
課	(课|課)
誶	(谇|誶)
誹	(诽|誹)
誼	(谊|誼)
誾	(訚|誾)
調	(调|調)
諁	(啜|欼|歠|諁)
諂	(谄|諂)
諄	(谆|諄)
談	(譚|谈|談|谭)
諉	(诿|餵|諉|喂|餧|餒|馁)
諊	(鞫|諊)
請	(请|請)
諌	(諫|諌|谏)
諍	(诤|諍)
諏	(诹|諏)
諑	(诼|諑)
諒	(谅|諒|諒)
諕	(唬|猇|虓|諕)
論	(论|論|論)
諗	(谂|諗)
諛	(谀|諛)
諜	(谍|諜)
諝	(谞|諝)
諞	(谝|諞)
諠	(喧|吅|諠)
諡	(謚|諡|谥)
諢	(诨|諢)
諤	(囮|讍|谔|諤|𡈙)
諦	(谛|諦)
諧	(谐|龤|諧)
諩	(譜|諩|谱)
諫	(諌|谏|諫)
諭	(谕|諭)
諮	(咨|嗞|谘|諮)
諰	(𫍰|諰)
諱	(讳|諱)
諳	(谙|諳)
諵	(喃|娚|嫐|諵)
諶	(訦|谌|諶)
諷	(讽|諷)
諸	(诸|諸|諸)
諺	(谚|諺)
諼	(煖|谖|娠|暖|諼|㛛)
諾	(诺|諾|諾)
謀	(谋|謀)
謁	(谒|謁)
謂	(谓|謂)
謄	(誊|謄)
謅	(诌|謅)
謊	(詤|谎|謊)
謌	(歌|謌)
謎	(谜|謎)
謏	(𫍲|謏)
謐	(谧|謐)
謔	(谑|謔)
謖	(谡|謖)
謗	(谤|謗)
謙	(谦|謙)
謚	(諡|谥|謚)
講	(讲|講)
謝	(谢|謝)
謠	(謡|谣|謠)
謡	(謠|謡|谣)
謨	(谟|謨)
謫	(讁|谪|謫)
謬	(谬|謬)
謭	(譾|谫|謭)
謱	(嘍|喽|謱)
謳	(讴|謳)
謹	(谨|謹)
謼	(呼|嘑|虖|謼)
謾	(谩|謾)
譁	(哗|嘩|譁)
譈	(憝|懟|譈|怼)
證	(証|证|證)
譊	(𫍢|譊)
譌	(訛|譌|讹)
譎	(憰|谲|譎)
譏	(讥|譏)
譐	(噂|譐)
譔	(𬤥|譔)
譖	(谮|譖)
識	(识|識|識)
譙	(誚|谯|譙|诮)
譚	(談|谭|譚|谈)
譜	(諩|谱|譜)
譟	(噪|喿|譟)
警	(儆|警)
譫	(谵|譫)
譭	(䛼|譭)
譯	(訳|译|譯)
議	(议|議)
譱	(善|譱)
譲	(讓|譲|让)
譴	(谴|譴)
護	(护|護)
譸	(诪|譸)
譽	(域|誉|㽣|譽)
譾	(謭|谫|譾)
讀	(読|读|讀|讀)
讁	(謫|讁|谪)
讃	(讚|讃)
讅	(谉|讅)
讆	(讏|讆)
變	(变|変|變)
讋	(詟|讋)
讌	(䜩|宴|燕|讌|醼|鷰)
讍	(諤|囮|讍|谔|𡈙)
讎	(仇|讐|雠|讎)
讏	(讆|讏)
讐	(仇|讎|讐|雠)
讒	(谗|讒)
讓	(譲|让|讓)
讕	(谰|讕)
讖	(谶|讖)
讘	(囁|嗫|讘)
讙	(歡|懽|欢|歓|讙|驩)
讚	(讃|讚)
讜	(谠|讜)
讞	(谳|讞)
讠	(言|訁|讠)
计	(計|计)
订	(訂|订)
讣	(訃|讣)
认	(認|认)
讥	(譏|讥)
讦	(訐|讦)
讧	(訌|讧)
讨	(討|讨)
让	(讓|譲|让)
讪	(訕|讪)
讫	(訖|讫)
讬	(託|侂|讬)
训	(訓|训)
议	(議|议)
讯	(訊|讯)
记	(記|记)
讱	(訒|讱)
讲	(講|讲)
讳	(諱|讳)
讴	(謳|讴)
讵	(詎|讵)
讶	(訝|讶)
讷	(訥|吶|讷|呐)
许	(許|许)
讹	(訛|譌|讹)
论	(論|论|論)
讻	(訩|詾|讻)
讼	(訟|讼)
讽	(諷|讽)
设	(設|设)
访	(訪|访)
诀	(訣|诀)
证	(證|証|证)
诂	(詁|诂)
诃	(呵|訶|嗬|诃)
评	(評|评)
诅	(詛|诅)
识	(識|识|識)
诇	(詗|诇)
诈	(詐|诈|醡|榨|酢|醋)
诉	(訴|愬|诉)
诊	(診|诊)
诋	(詆|诋)
诌	(謅|诌)
词	(詞|词)
诎	(詘|诎)
诏	(詔|诏)
诐	(詖|诐)
译	(譯|訳|译)
诒	(詒|诒)
诓	(誆|诓)
诔	(誄|诔)
试	(試|试)
诖	(詿|诖)
诗	(詩|诗)
诘	(詰|诘)
诙	(詼|诙)
诚	(誠|诚)
诛	(誅|诛)
诜	(詵|侁|诜|駪)
话	(話|䛡|话)
诞	(誕|诞|𧩙|䜥)
诟	(詬|呴|訽|诟)
诠	(詮|诠)
诡	(詭|诡)
询	(詢|询)
诣	(詣|诣)
诤	(諍|诤)
该	(該|该)
详	(詳|详)
诧	(詫|诧)
诨	(諢|诨)
诩	(詡|诩)
诪	(譸|诪)
诫	(誡|诫)
诬	(誣|诬)
语	(語|语)
诮	(誚|譙|诮|谯)
误	(誤|悞|误|悮)
诰	(誥|诰)
诱	(誘|䛻|诱)
诲	(誨|诲)
诳	(誑|诳)
说	(說|説|说|說|說)
诵	(誦|诵)
诶	(唉|誒|欸|诶)
请	(請|请)
诸	(諸|諸|诸)
诹	(諏|诹)
诺	(諾|诺|諾)
读	(讀|読|读|讀)
诼	(諑|诼)
诽	(誹|诽)
课	(課|课)
诿	(諉|诿|餵|喂|餧|餒|馁)
谀	(諛|谀)
谁	(誰|谁)
谂	(諗|谂)
调	(調|调)
谄	(諂|谄)
谅	(諒|谅|諒)
谆	(諄|谆)
谇	(誶|谇)
谈	(談|譚|谈|谭)
谉	(讅|谉)
谊	(誼|谊)
谋	(謀|谋)
谌	(諶|訦|谌)
谍	(諜|谍)
谎	(謊|詤|谎)
谏	(諫|諌|谏)
谐	(諧|谐|龤)
谑	(謔|谑)
谒	(謁|谒)
谓	(謂|谓)
谔	(諤|囮|讍|谔|𡈙)
谕	(諭|谕)
谖	(諼|煖|谖|娠|暖|㛛)
谗	(讒|谗)
谘	(咨|諮|嗞|谘)
谙	(諳|谙)
谚	(諺|谚)
谛	(諦|谛)
谜	(謎|谜)
谝	(諞|谝)
谞	(諝|谞)
谟	(謨|谟)
谠	(讜|谠)
谡	(謖|谡)
谢	(謝|谢)
谣	(謠|謡|谣)
谤	(謗|谤)
谥	(謚|諡|谥)
谦	(謙|谦)
谧	(謐|谧)
谨	(謹|谨)
谩	(謾|谩)
谪	(謫|讁|谪)
谫	(謭|譾|谫)
谬	(謬|谬)
谭	(譚|談|谭|谈)
谮	(譖|谮)
谯	(譙|誚|谯|诮)
谰	(讕|谰)
谱	(譜|諩|谱)
谲	(譎|憰|谲)
谳	(讞|谳)
谴	(譴|谴)
谵	(譫|谵)
谶	(讖|谶)
谷	(穀|糓|谷)
谿	(嵠|谿)
豆	(荳|豆)
豇	(䜶|豇)
豈	(岂|豈|豈)
豊	(豐|丰|豊)
豋	(登|豋)
豎	(竖|竪|豎)
豐	(丰|豊|豐)
豓	(艶|豔|豓|艳|艷)
豔	(艳|艶|艷|豓|豔)
豘	(豚|豘)
豚	(豘|豚)
豜	(豣|豜)
豝	(羓|豝)
象	(像|象)
豣	(豜|豣)
豫	(予|預|余|豫|预|餘|馀)
豬	(猪|豬|猪)
豮	(豶|豮)
豳	(㟗|邠|豳)
豴	(蹢|豴)
豵	(䝋|豵)
豶	(豮|豶)
豸	(廌|豸)
豺	(犲|豺)
豻	(犴|豻)
貉	(狢|貉)
貊	(貘|貊)
貌	(皃|貌|貎)
貍	(狸|貍)
貎	(皃|貌|貎)
貓	(猫|貓)
貘	(貊|貘)
貙	(䝙|貙)
貛	(獾|貛)
貝	(贝|貝)
貞	(贞|貞)
貟	(贠|貟)
負	(负|負)
財	(㒲|才|财|財|纔)
貢	(贡|貢)
貧	(贫|貧)
貨	(货|貨)
販	(贩|𧶶|販)
貪	(贪|貪)
貫	(贯|貫)
責	(拆|责|責)
貭	(質|貭|质)
貮	(二|弍|貮|貳|贰)
貯	(贮|貯)
貰	(贳|貰)
貲	(赀|貲)
貳	(二|弍|贰|貮|貳)
貴	(贵|貴)
貶	(贬|貶)
買	(买|買)
貸	(贷|貸)
貺	(贶|貺)
費	(费|費)
貼	(贴|貼)
貽	(贻|貽)
貿	(贸|貿)
賀	(贺|賀)
賁	(贲|賁)
賂	(赂|賂|賂)
賃	(赁|賃)
賄	(贿|賄)
賅	(侅|赅|賅)
資	(资|資)
賈	(贾|賈|賈)
賉	(恤|卹|賉)
賊	(戝|贼|賊)
賍	(贓|贜|賍|赃)
賑	(赈|賑)
賒	(赊|賒)
賓	(宾|賔|賓)
賔	(賓|宾|賔)
賕	(赇|賕)
賙	(赒|賙)
賚	(赉|賚)
賛	(贊|賛|赞)
賜	(赐|賜)
賞	(赏|賞)
賟	(𧹖|賟)
賠	(赔|賠)
賡	(赓|賡)
賢	(贒|贤|賢)
賣	(卖|売|賣)
賤	(贱|賤)
賦	(赋|賦)
賧	(赕|賧)
質	(貭|质|質)
賫	(齎|賫|赍)
賬	(帳|账|帐|賬)
賭	(赌|賭)
賮	(贐|賮|赆)
賰	(䞐|賰)
賴	(赖|頼|賴)
賵	(赗|賵)
賸	(剩|剰|賸)
賺	(贃|赚|𧸖|賺|𧹗)
賻	(赙|賻)
購	(购|購)
賽	(赛|賽)
賾	(赜|賾)
贃	(賺|𧸖|𧹗|贃|赚)
贄	(贽|贄)
贅	(赘|贅)
贇	(赟|贇)
贈	(赠|贈)
贊	(賛|赞|贊)
贋	(偐|贗|赝|贋)
贍	(赡|贍)
贏	(赢|贏)
贐	(賮|赆|贐)
贒	(賢|贒|贤)
贓	(賍|贜|赃|贓)
贔	(赑|贔)
贖	(赎|贖)
贗	(偐|贋|赝|贗)
贛	(赣|贛)
贜	(賍|贓|贜|赃)
贝	(貝|贝)
贞	(貞|贞)
负	(負|负)
贠	(貟|贠)
贡	(貢|贡)
财	(財|㒲|才|财|纔)
责	(責|拆|责)
贤	(賢|贒|贤)
败	(敗|䢙|败)
账	(帳|賬|帐|账)
货	(貨|货)
质	(質|貭|质)
贩	(販|贩|𧶶)
贪	(貪|贪)
贫	(貧|贫)
贬	(貶|贬)
购	(購|购)
贮	(貯|贮)
贯	(貫|贯)
贰	(二|貳|弍|貮|贰)
贱	(賤|贱)
贲	(賁|贲)
贳	(貰|贳)
贴	(貼|贴)
贵	(貴|贵)
贶	(貺|贶)
贷	(貸|贷)
贸	(貿|贸)
费	(費|费)
贺	(賀|贺)
贻	(貽|贻)
贼	(賊|戝|贼)
贽	(贄|贽)
贾	(賈|贾|賈)
贿	(賄|贿)
赀	(貲|赀)
赁	(賃|赁)
赂	(賂|赂|賂)
赃	(贓|賍|贜|赃)
资	(資|资)
赅	(賅|侅|赅)
赆	(贐|賮|赆)
赇	(賕|赇)
赈	(賑|赈)
赉	(賚|赉)
赊	(賒|赊)
赋	(賦|赋)
赌	(賭|赌)
赍	(齎|賫|赍)
赎	(贖|赎)
赏	(賞|赏)
赐	(賜|赐)
赑	(贔|赑)
赒	(賙|赒)
赓	(賡|赓)
赔	(賠|赔)
赕	(賧|赕)
赖	(賴|赖|頼)
赗	(賵|赗)
赘	(贅|赘)
赙	(賻|赙)
赚	(賺|贃|赚|𧸖|𧹗)
赛	(賽|赛)
赜	(賾|赜)
赝	(贋|贗|偐|赝)
赞	(贊|賛|赞)
赟	(贇|赟)
赠	(贈|赠)
赡	(贍|赡)
赢	(贏|赢)
赣	(贛|赣)
赤	(𤆍|赤)
赪	(赬|䞓|赪)
赬	(䞓|赪|赬)
走	(赱|走)
赱	(走|赱)
赵	(趙|赵)
赶	(趕|赶)
趁	(趂|趁)
趂	(趁|趂)
趄	(跙|趄)
趋	(趨|趋)
趒	(跳|趒)
趕	(赶|趕)
趙	(赵|趙)
趨	(趋|趨)
趮	(躁|趮)
趯	(躍|趯|跃)
趱	(趲|趱)
趲	(趱|趲)
趸	(躉|趸)
跃	(躍|趯|跃)
跄	(蹌|牄|跄)
跐	(跴|跐|踹)
跖	(蹠|跖)
跙	(趄|跙)
跞	(躒|跞)
跡	(蹟|迹|速|跡)
跥	(跺|跥)
路	(路|路)
跳	(趒|跳)
跴	(跐|踹|跴)
践	(踐|践)
跶	(躂|跶)
跷	(蹺|屩|跷|蹻|𪨗|𫏋)
跸	(蹕|跸)
跹	(躚|跹|蹮)
跺	(跥|跺)
跻	(躋|跻|隮)
踁	(硜|䃘|硁|踁)
踊	(踴|踊)
踌	(躊|踌)
踏	(蹋|踏|蹹)
踐	(践|踐)
踦	(犄|踦)
踨	(蹤|踨|踪)
踪	(蹤|踨|踪)
踬	(躓|踬)
踭	(㬹|踭)
踯	(躑|踯)
踰	(逾|踰)
踴	(踊|踴)
踵	(歱|踵)
踹	(跴|跐|踹)
踽	(偊|踽)
蹄	(蹏|蹄)
蹋	(踏|蹹|蹋)
蹌	(牄|跄|蹌)
蹏	(蹄|蹏)
蹑	(躡|蹑)
蹒	(蹣|蹒)
蹕	(跸|蹕)
蹝	(屣|躧|蹝)
蹟	(跡|迹|速|蹟)
蹠	(跖|蹠)
蹢	(豴|蹢)
蹣	(蹒|蹣)
蹤	(踨|踪|蹤)
蹧	(遭|蹧)
蹭	(矰|蹭)
蹮	(躚|跹|蹮)
蹯	(番|蹯)
蹰	(躕|蹰)
蹴	(蹵|蹴)
蹵	(蹴|蹵)
蹶	(蹷|蹶)
蹷	(蹶|蹷)
蹹	(蹋|踏|蹹)
蹺	(屩|跷|蹻|蹺|𪨗|𫏋)
蹻	(蹺|𫏋|屩|跷|蹻|𪨗)
蹿	(躥|蹿)
躁	(趮|躁)
躂	(跶|躂)
躅	(䠱|躅)
躉	(趸|躉)
躊	(踌|躊)
躋	(跻|隮|躋)
躍	(趯|跃|躍)
躎	(䟢|躎)
躏	(躪|躏)
躑	(踯|躑)
躒	(跞|躒)
躓	(踬|躓)
躕	(蹰|躕)
躗	(躛|躗)
躚	(跹|蹮|躚)
躛	(躗|躛)
躜	(躦|躜)
躝	(𨅬|躝)
躡	(蹑|躡)
躥	(蹿|躥)
躦	(躜|躦)
躧	(屣|蹝|躧)
躪	(躏|躪)
躬	(躳|躬)
躭	(眈|耽|躭)
躯	(軀|躯)
躰	(體|体|躰|軆|骵)
躱	(躲|躱)
躲	(躱|躲)
躳	(躬|躳)
躶	(裸|躶|裸)
躷	(矮|躷)
軀	(躯|軀)
軄	(職|职|軄)
軆	(体|體|軆|躰|骵)
軉	(𨉗|軉)
車	(车|車|車)
軋	(轧|軋)
軌	(轨|軌)
軍	(军|軍)
軏	(𫐄|軏)
軑	(轪|軑)
軒	(轩|軒)
軔	(轫|軔)
軗	(𨐅|軗)
軛	(轭|軛)
軟	(輭|软|軟)
転	(轉|転|转)
軣	(轟|軣|轰)
軤	(轷|軤)
軨	(𫐉|軨)
軫	(轸|軫)
軰	(輩|軰|辈)
軲	(轂|轱|毂|軲)
軸	(轴|軸)
軹	(轵|軹)
軺	(轺|𨍳|軺)
軻	(轲|軻)
軼	(轶|軼)
軽	(輕|軽|轻)
軾	(轼|軾)
軿	(輧|軿)
較	(较|較)
輄	(𨐈|輄)
輅	(辂|輅)
輇	(辁|輇)
輈	(辀|輈)
載	(儎|载|傤|載)
輊	(轾|輊)
輌	(輛|輌|辆)
輒	(輙|辄|輒)
輓	(挽|掇|輓)
輔	(辅|輔)
輕	(軽|轻|輕)
輗	(𫐐|輗)
輙	(輒|輙|辄)
輛	(輌|辆|輛)
輜	(辎|輜)
輝	(煇|辉|輝)
輞	(辋|輞)
輟	(辍|輟)
輥	(辊|輥)
輦	(襜|辇|輦|襝|輦|裣)
輧	(軿|輧)
輩	(軰|辈|輩)
輪	(轮|輪|輪)
輬	(辌|輬)
輭	(軟|輭|软)
輮	(𫐓|輮)
輯	(辑|輯)
輳	(辏|輳)
輵	(轕|輵)
輸	(输|輸)
輻	(辐|輻|輻)
輼	(轀|輼|辒)
輾	(辗|輾)
輿	(舆|轝|輿)
轀	(輼|辒|轀)
轂	(毂|軲|轂|轱)
轄	(辖|鎋|轄)
轅	(辕|轅)
轆	(樚|辘|轆)
轉	(転|转|轉)
轍	(辙|轍)
轎	(轿|轎)
轔	(辚|轔)
轕	(輵|轕)
轗	(㙳|轗)
轝	(輿|舆|轝)
轟	(軣|轰|轟)
轡	(辔|轡)
轢	(轹|轢|轢)
轣	(𫐆|轣)
轤	(轳|轤)
车	(車|车|車)
轧	(軋|轧)
轨	(軌|轨)
轩	(軒|轩)
轪	(軑|轪)
轫	(軔|轫)
转	(轉|転|转)
轭	(軛|轭)
轮	(輪|轮|輪)
软	(軟|輭|软)
轰	(轟|軣|轰)
轱	(軲|轂|轱|毂)
轲	(軻|轲)
轳	(轤|轳)
轴	(軸|轴)
轵	(軹|轵)
轶	(軼|轶)
轷	(軤|轷)
轸	(軫|轸)
轹	(轢|轹|轢)
轺	(軺|轺|𨍳)
轻	(輕|軽|轻)
轼	(軾|轼)
载	(載|儎|载|傤)
轾	(輊|轾)
轿	(轎|轿)
辀	(輈|辀)
辁	(輇|辁)
辂	(輅|辂)
较	(較|较)
辄	(輒|輙|辄)
辅	(輔|辅)
辆	(輛|輌|辆)
辇	(輦|襜|辇|輦|襝|裣)
辈	(輩|軰|辈)
辉	(輝|煇|辉)
辊	(輥|辊)
辋	(輞|辋)
辌	(輬|辌)
辍	(輟|辍)
辎	(輜|辎)
辏	(輳|辏)
辐	(輻|辐|輻)
辑	(輯|辑)
辒	(轀|輼|辒)
输	(輸|输)
辔	(轡|辔)
辕	(轅|辕)
辖	(轄|辖|鎋)
辗	(輾|辗)
辘	(轆|樚|辘)
辙	(轍|辙)
辚	(轔|辚)
辞	(辤|辭|辞)
辟	(避|辟)
辠	(罪|辠)
辢	(辣|辢)
辣	(辢|辣)
辤	(辞|辭|辤)
辦	(办|辦)
辧	(辨|弁|辧|辯|辩)
辨	(弁|辧|辯|辨|辩)
辩	(辯|辨|辩|弁|辧)
辫	(辮|辫)
辭	(辞|辤|辭)
辮	(辫|辮)
辯	(辨|辩|弁|辧|辯)
辰	(辰|辰)
農	(农|莀|農)
辵	(辶|辵)
辶	(辵|辶)
边	(邊|边|辺|邉)
辺	(邊|边|辺|邉)
辽	(遼|辽|遼)
达	(達|达|逹)
迁	(遷|迁)
迂	(遇|迂)
迆	(迤|迆)
过	(過|过)
迈	(邁|迈)
迊	(匝|帀|迊)
运	(運|运)
迕	(忤|啎|迕)
还	(還|还)
这	(這|这)
进	(進|进)
远	(遠|远|逺)
违	(違|违)
连	(連|连|連)
迟	(遲|迟|遅|遟)
迤	(迆|迤)
迥	(逈|迥)
迨	(逮|迨)
迩	(邇|迩)
迪	(廸|迪)
迫	(廹|迫)
迬	(往|徃|迬)
迭	(疊|叠|曡|畳|疉|迭)
迯	(逃|迯)
迳	(徑|逕|俓|勁|径|迳|劲)
迴	(回|廻|囘|囬|廽|迴|逥)
迹	(跡|蹟|速|迹)
迺	(乃|廼|迺)
迻	(移|迻)
适	(適|适)
逃	(迯|逃)
逈	(迥|逈)
选	(選|选)
逊	(遜|愻|逊)
递	(遞|递|逓)
逓	(遞|递|逓)
逕	(徑|迳|俓|勁|径|逕|劲)
逖	(逷|逖)
這	(这|這)
逞	(期|朞|逞|稘)
速	(跡|蹟|迹|速)
連	(连|連|連)
逥	(回|囘|囬|廻|廽|迴|逥)
逦	(邐|逦)
逩	(奔|犇|逩)
逮	(迨|逮)
逰	(游|逰|遊)
週	(周|週)
進	(进|進)
逷	(逖|逷)
逸	(逸|逸)
逹	(達|达|逹)
逺	(遠|远|逺)
逻	(邏|逻|邏)
逼	(偪|逼)
逾	(踰|逾)
逿	(盪|𨌩|荡|蕩|蘯|逿|偒)
遅	(遲|迟|遅|遟)
遇	(迂|遇)
遊	(游|逰|遊)
運	(运|運)
遍	(徧|遍)
過	(过|過)
遑	(徨|遑)
達	(达|逹|達)
違	(违|違)
遗	(遺|遗)
遙	(遥|遙)
遜	(愻|逊|遜)
遞	(递|逓|遞)
遟	(遲|迟|遅|遟)
遠	(远|逺|遠)
遡	(泝|溯|遡|㴑)
遥	(遙|遥)
適	(适|適)
遭	(蹧|遭)
遲	(迟|遅|遟|遲)
遶	(繞|绕|遶)
遷	(迁|遷)
選	(选|選)
遺	(遗|遺)
遼	(辽|遼|遼)
避	(辟|避)
邁	(迈|邁)
還	(还|還)
邅	(㣶|邅)
邇	(迩|邇)
邉	(邊|边|辺|邉)
邊	(边|辺|邉|邊)
邏	(逻|邏|邏)
邐	(逦|邐)
邑	(阝|邑|阜)
邓	(鄧|邓)
邕	(雍|𪪝|邕|雝|廱|簌)
邝	(鄺|邝)
邠	(㟗|豳|邠)
邢	(郉|邢)
邨	(村|邨)
邬	(鄔|塢|邬|坞|隖|隝)
邮	(郵|邮)
邹	(鄒|邹)
邺	(鄴|邺)
邻	(鄰|邻|隣|隣)
郁	(喐|鬱|郁|欝|鬰)
郄	(郤|隙|郄)
郅	(胝|郅)
郉	(邢|郉)
郎	(郞|郎|郎)
郏	(郟|郏)
郐	(鄶|郐)
郑	(鄭|郑)
郓	(鄆|郓)
郞	(郎|郞|郎)
郟	(郏|郟)
郤	(郄|郤|隙)
郦	(酈|郦)
郧	(鄖|郧)
部	(卩|㔾|節|部|罇|节|墫|樽)
郰	(鄹|郰)
郵	(邮|郵)
郷	(鄉|乡|郷|鄕)
郸	(鄲|郸)
都	(都|都)
鄆	(郓|鄆)
鄉	(乡|郷|鄕|鄉)
鄒	(邹|鄒)
鄔	(塢|邬|坞|鄔|隖|隝)
鄕	(鄉|乡|郷|鄕)
鄖	(郧|鄖)
鄧	(邓|鄧)
鄭	(郑|鄭)
鄰	(邻|隣|隣|鄰)
鄲	(郸|鄲)
鄴	(邺|鄴)
鄶	(郐|鄶)
鄷	(酆|鄷)
鄹	(郰|鄹)
鄺	(邝|鄺)
酂	(酇|酂)
酆	(鄷|酆)
酇	(酂|酇)
酈	(郦|酈)
酉	(丣|酋|酉)
酋	(酉|丣|酋)
酔	(醉|酔)
酖	(鴆|酖|鸩)
酝	(醞|酝|醖)
酢	(榨|醋|酢|醡|詐|诈)
酦	(醱|酦|醗)
酧	(酬|醻|詶|酧)
酪	(酪|酪)
酬	(詶|酧|醻|酬)
酱	(醬|酱|醤)
酹	(儡|酹)
酽	(釅|酽)
酾	(釃|酾)
酿	(釀|酿|醸)
醃	(腌|醃|骯|肮)
醇	(䣩|醇)
醉	(酔|醉)
醊	(餟|醊)
醋	(酢|榨|醋|醡|詐|诈)
醑	(湑|醑)
醒	(惺|醒|𢜫)
醖	(醞|酝|醖)
醗	(醱|酦|醗)
醜	(丑|醜)
醞	(酝|醖|醞)
醡	(榨|詐|酢|醡|诈|醋)
醤	(醬|酱|醤)
醩	(糟|醩)
醫	(医|醫)
醬	(酱|醤|醬)
醱	(酦|醗|醱)
醴	(醴|醴)
醸	(釀|酿|醸)
醻	(酧|酬|醻|詶)
醼	(燕|讌|醼|鷰|䜩|宴)
釀	(酿|醸|釀)
釁	(衅|釁)
釃	(酾|釃)
釅	(酽|釅)
釆	(采|埰|採|釆)
采	(埰|採|釆|采)
釈	(釋|釈|释)
释	(釋|釈|释)
釋	(釈|释|釋)
里	(裏|裡|里|里|裏|裡)
野	(埜|野)
量	(量|量)
釐	(厘|𭀖|釐)
金	(釒|钅|金|金)
釒	(金|钅|釒|金)
釓	(钆|釓)
釔	(钇|釔)
釕	(钌|釕)
釖	(劍|剑|剣|剱|劒|劔|釖|釼|劎)
釗	(钊|釗)
釘	(钉|釘)
釙	(钋|釙)
釜	(釡|釜)
針	(箴|鍼|针|針)
釡	(釜|釡)
釣	(钓|釣)
釤	(钐|釤)
釧	(钏|釧)
釩	(钒|釩)
釬	(銲|釬)
釳	(𨰿|釳)
釵	(叉|钗|釵)
釷	(钍|釷)
釹	(钕|釹)
釺	(钎|釺)
釼	(劍|剑|剣|剱|劒|劔|釖|釼|劎)
釾	(䥺|釾)
鈀	(耙|钯|鈀)
鈁	(钫|鈁)
鈃	(钘|鈃)
鈄	(钭|鈄)
鈆	(鉛|鈆|铅)
鈇	(𫓧|鈇)
鈈	(钚|鈈)
鈉	(钠|鈉)
鈋	(𨱂|鈋)
鈍	(钝|鈍)
鈎	(鉤|鈎|钩)
鈐	(钤|鈐)
鈑	(钣|鈑)
鈒	(钑|鈒)
鈔	(钞|鈔)
鈕	(钮|鈕)
鈞	(銁|钧|鈞)
鈠	(𨱁|鈠)
鈡	(鍾|鈡|鐘|钟|锺)
鈣	(钙|鈣)
鈥	(钬|鈥)
鈦	(钛|鈦)
鈧	(钪|鈧)
鈬	(鐸|鈬|铎)
鈮	(铌|鈮)
鈯	(𨱄|鈯)
鈰	(铈|鈰)
鈲	(𨱃|鈲)
鈳	(钶|鈳)
鈴	(铃|鈴|鈴)
鈷	(钴|鈷)
鈸	(钹|鈸)
鈹	(铍|鈹)
鈺	(钰|鈺)
鈽	(钸|鈽)
鈾	(铀|鈾)
鈿	(钿|鈿)
鉀	(钾|鉀)
鉁	(𨱅|鉁)
鉄	(銕|鐵|鉄|鐡|铁)
鉅	(巨|钜|鉅)
鉆	(鉗|鑽|箝|鉆|钳|鑚|钻)
鉈	(砣|铊|𥓿|鉈)
鉉	(铉|鉉)
鉋	(刨|铇|鉋)
鉍	(铋|鉍)
鉏	(鋤|耡|鉏|锄)
鉑	(铂|鉑)
鉕	(钷|鉕)
鉗	(箝|鉆|钳|鉗|鑽|鑚|钻)
鉚	(铆|鉚)
鉛	(鈆|铅|鉛)
鉞	(戉|钺|鉞)
鉢	(缽|鉢|钵)
鉤	(鈎|钩|鉤)
鉦	(钲|鉦)
鉨	(鿭|鉨|鑈)
鉬	(钼|鉬)
鉭	(钽|鉭)
鉱	(礦|矿|砿|鉱|鑛)
鉴	(鑒|鉴|鑑)
鉶	(铏|鉶)
鉸	(铰|鉸)
鉺	(铒|鉺)
鉻	(铬|鉻)
鉿	(铪|鉿)
銀	(银|銀)
銁	(鈞|銁|钧)
銃	(铳|銃)
銅	(铜|銅)
銍	(铚|銍)
銑	(铣|銑)
銓	(铨|銓)
銕	(鉄|鐵|銕|鐡|铁)
銖	(铢|銖)
銘	(铭|銘)
銚	(铫|銚)
銛	(铦|銛)
銜	(㘅|衔|啣|銜)
銠	(铑|銠)
銣	(铷|銣)
銥	(铱|銥)
銦	(铟|銦)
銨	(铵|銨)
銩	(铥|銩)
銪	(铕|銪)
銫	(铯|銫)
銬	(铐|銬)
銭	(錢|銭|钱)
銮	(鑾|銮)
銱	(铞|銱)
銲	(釬|銲)
銳	(鋭|锐|銳)
銶	(𨱇|銶)
銷	(销|銷)
銹	(鏥|鏽|銹|锈)
銻	(锑|銻)
銼	(剉|锉|銼)
鋁	(铝|鋁)
鋃	(锒|鋃)
鋄	(錽|鋄)
鋅	(锌|鋅)
鋇	(钡|鋇)
鋉	(𨱈|鋉)
鋌	(铤|鋌)
鋏	(铗|鋏)
鋑	(鐫|鑴|鋑|镌)
鋒	(锋|鋒)
鋙	(铻|鋙)
鋝	(锊|鋝)
鋟	(锓|鋟)
鋣	(铘|鋣)
鋤	(耡|鉏|锄|鋤)
鋥	(锃|鋥)
鋦	(锔|鋦)
鋨	(锇|鋨)
鋩	(铓|鋩)
鋪	(舖|舗|铺|鋪)
鋭	(銳|鋭|锐)
鋮	(铖|鋮)
鋯	(锆|鋯)
鋰	(锂|鋰)
鋱	(铽|鋱)
鋳	(鑄|鋳|铸)
鋶	(锍|鋶)
鋸	(锯|鋸)
鋼	(钢|鋼)
錁	(锞|錁)
錂	(𨱋|錂)
錄	(录|録|錄|錄)
錆	(锖|錆)
錇	(锫|錇)
錈	(锩|錈)
錋	(镚|錋|鏰|斆|敩|斅|𢽾)
錏	(铔|錏)
錐	(锥|錐)
錒	(锕|錒)
錕	(锟|錕)
錘	(鎚|锤|錘)
錙	(锱|錙)
錚	(铮|錚)
錛	(锛|錛)
錟	(锬|錟)
錠	(锭|錠)
錡	(锜|錡)
錢	(銭|钱|錢)
錦	(锦|錦)
錨	(锚|錨)
錩	(锠|錩)
錫	(锡|錫|钖|鍚)
錬	(煉|炼|錬|煉)
錮	(锢|錮)
錯	(错|錯)
録	(錄|录|録|錄)
錳	(锰|錳)
錶	(表|錶)
錸	(铼|錸)
錽	(鋄|錽)
錾	(鏨|錾)
鍀	(锝|鍀)
鍃	(锪|鍃)
鍄	(𨱉|鍄)
鍆	(钔|鍆)
鍇	(锴|鍇)
鍈	(锳|鍈)
鍉	(匙|鍉)
鍊	(鍊|鍊)
鍋	(锅|鍋)
鍍	(镀|鍍)
鍔	(锷|鍔)
鍘	(铡|鍘)
鍚	(钖|鍚|锡|錫)
鍛	(煅|锻|鍛)
鍜	(煆|鍜)
鍠	(锽|鍠)
鍤	(锸|鍤)
鍥	(锲|鍥)
鍩	(锘|鍩)
鍫	(鍬|鍫|锹)
鍬	(鍫|锹|鍬)
鍮	(𨱎|鍮)
鍰	(鐶|锾|鍰|镮)
鍵	(键|鍵)
鍶	(锶|鍶)
鍺	(锗|鍺)
鍼	(箴|針|鍼|针)
鍾	(鈡|鐘|钟|锺|鍾)
鎂	(镁|鎂)
鎄	(锿|鎄)
鎇	(镅|鎇)
鎊	(镑|鎊)
鎋	(轄|辖|鎋)
鎌	(鐮|劆|鎌|镰)
鎏	(鏐|鎏|镠)
鎒	(耨|鎒)
鎔	(熔|镕|鎔)
鎖	(鎻|鏁|锁|鎖)
鎘	(镉|鎘)
鎙	(槊|鎙)
鎚	(錘|鎚|锤)
鎛	(镈|鎛)
鎝	(𨱏|鎝)
鎡	(镃|鎡)
鎢	(钨|鎢)
鎣	(蓥|鎣)
鎦	(镏|鎦)
鎧	(铠|鎧)
鎩	(铩|鎩)
鎪	(锼|鎪)
鎬	(镐|鎬)
鎭	(鎮|鎭|镇)
鎮	(鎭|镇|鎮)
鎯	(𨱍|鎯)
鎰	(镒|鎰)
鎲	(镋|鎲|钂)
鎳	(镍|鎳)
鎵	(镓|鎵)
鎶	(鿔|鎶)
鎷	(𨰾|鎷)
鎻	(鎖|鎻|鏁|锁)
鎿	(镎|鎿)
鏁	(鎖|鎻|鏁|锁)
鏃	(镞|鏃)
鏆	(𨱌|鏆)
鏇	(镟|鏇)
鏈	(链|鏈)
鏉	(𨱒|鏉)
鏌	(镆|鏌)
鏍	(镙|鏍)
鏐	(鎏|镠|鏐)
鏑	(镝|鏑)
鏗	(铿|鏗)
鏘	(锵|鏘)
鏜	(镗|鏜)
鏝	(镘|鏝)
鏞	(镛|鏞)
鏟	(剗|剷|铲|刬|鏟)
鏡	(镜|鏡)
鏢	(鑣|镖|鏢|镳)
鏤	(镂|鏤)
鏥	(銹|鏽|鏥|锈)
鏦	(𫓩|鏦)
鏨	(錾|鏨)
鏰	(斆|镚|敩|斅|鏰|錋|𢽾)
鏵	(铧|鏵)
鏷	(镤|鏷)
鏹	(镪|鏹)
鏺	(䥽|鏺)
鏽	(銹|鏥|锈|鏽)
鏾	(𠜎|鏾)
鐀	(匱|櫃|匮|樻|鐀|饋|柜|餽|馈)
鐃	(铙|鐃)
鐄	(𨱑|鐄)
鐋	(铴|鐋)
鐍	(𫔎|鐍)
鐎	(𨱓|鐎)
鐏	(𨱔|鐏)
鐐	(镣|鐐)
鐒	(铹|鐒)
鐓	(镦|鐓)
鐔	(镡|鐔)
鐘	(鍾|钟|鈡|鐘|锺)
鐙	(镫|鐙)
鐠	(镨|鐠)
鐡	(鐵|鉄|銕|鐡|铁)
鐥	(䦅|鐥)
鐦	(锎|鐦)
鐧	(锏|鐧)
鐨	(镄|鐨)
鐫	(鋑|鑴|镌|鐫)
鐮	(劆|鎌|镰|鐮)
鐯	(䦃|鐯)
鐲	(镯|鐲)
鐳	(镭|鐳)
鐵	(鉄|銕|鐡|铁|鐵)
鐶	(鍰|镮|鐶|锾)
鐸	(鈬|铎|鐸)
鐺	(铛|鐺)
鐿	(镱|鐿)
鑄	(鋳|铸|鑄)
鑈	(鿭|鉨|鑈)
鑊	(镬|鑊)
鑌	(镔|鑌)
鑑	(鑒|鉴|鑑)
鑒	(鉴|鑑|鑒)
鑔	(镲|鑔)
鑕	(锧|鑕)
鑚	(鑽|鉆|鑚|钻|鉗|箝|钳)
鑛	(礦|矿|砿|鉱|鑛)
鑞	(镴|鑞)
鑠	(铄|鑠)
鑢	(䥨|鑢)
鑣	(鏢|镳|鑣|镖)
鑥	(镥|鑥)
鑭	(镧|鑭)
鑰	(钥|鑰)
鑱	(镵|鑱)
鑲	(镶|鑲)
鑴	(鋑|鐫|鑴|镌)
鑵	(罐|礶|缶|鑵|缻)
鑷	(镊|鑷)
鑹	(镩|鑹)
鑼	(锣|鑼)
鑽	(鉆|鑚|钻|鉗|鑽|箝|钳)
鑾	(銮|鑾)
鑿	(凿|鑿)
钁	(镢|钁)
钂	(镋|鎲|钂)
钅	(金|釒|钅|金)
钆	(釓|钆)
钇	(釔|钇)
针	(針|箴|鍼|针)
钉	(釘|钉)
钊	(釗|钊)
钋	(釙|钋)
钌	(釕|钌)
钍	(釷|钍)
钎	(釺|钎)
钏	(釧|钏)
钐	(釤|钐)
钑	(鈒|钑)
钒	(釩|钒)
钓	(釣|钓)
钔	(鍆|钔)
钕	(釹|钕)
钖	(鍚|锡|钖|錫)
钗	(釵|叉|钗)
钘	(鈃|钘)
钙	(鈣|钙)
钚	(鈈|钚)
钛	(鈦|钛)
钜	(巨|鉅|钜)
钝	(鈍|钝)
钞	(鈔|钞)
钟	(鍾|鐘|鈡|钟|锺)
钠	(鈉|钠)
钡	(鋇|钡)
钢	(鋼|钢)
钣	(鈑|钣)
钤	(鈐|钤)
钥	(鑰|钥)
钦	(欽|钦)
钧	(鈞|銁|钧)
钨	(鎢|钨)
钩	(鉤|鈎|钩)
钪	(鈧|钪)
钫	(鈁|钫)
钬	(鈥|钬)
钭	(鈄|钭)
钮	(鈕|钮)
钯	(鈀|耙|钯)
钰	(鈺|钰)
钱	(錢|銭|钱)
钲	(鉦|钲)
钳	(箝|鉗|钳|鉆|鑽|鑚|钻)
钴	(鈷|钴)
钵	(缽|鉢|钵)
钶	(鈳|钶)
钷	(鉕|钷)
钸	(鈽|钸)
钹	(鈸|钹)
钺	(鉞|戉|钺)
钻	(鑽|鉆|鑚|钻|鉗|箝|钳)
钼	(鉬|钼)
钽	(鉭|钽)
钾	(鉀|钾)
钿	(鈿|钿)
铀	(鈾|铀)
铁	(鐵|鉄|銕|鐡|铁)
铂	(鉑|铂)
铃	(鈴|铃|鈴)
铄	(鑠|铄)
铅	(鉛|鈆|铅)
铆	(鉚|铆)
铇	(鉋|刨|铇)
铈	(鈰|铈)
铉	(鉉|铉)
铊	(鉈|砣|铊|𥓿)
铋	(鉍|铋)
铌	(鈮|铌)
铍	(鈹|铍)
铎	(鐸|鈬|铎)
铏	(鉶|铏)
铐	(銬|铐)
铑	(銠|铑)
铒	(鉺|铒)
铓	(鋩|铓)
铔	(錏|铔)
铕	(銪|铕)
铖	(鋮|铖)
铗	(鋏|铗)
铘	(鋣|铘)
铙	(鐃|铙)
铚	(銍|铚)
铛	(鐺|铛)
铜	(銅|铜)
铝	(鋁|铝)
铞	(銱|铞)
铟	(銦|铟)
铠	(鎧|铠)
铡	(鍘|铡)
铢	(銖|铢)
铣	(銑|铣)
铤	(鋌|铤)
铥	(銩|铥)
铦	(銛|铦)
铧	(鏵|铧)
铨	(銓|铨)
铩	(鎩|铩)
铪	(鉿|铪)
铫	(銚|铫)
铬	(鉻|铬)
铭	(銘|铭)
铮	(錚|铮)
铯	(銫|铯)
铰	(鉸|铰)
铱	(銥|铱)
铲	(鏟|剗|剷|铲|刬)
铳	(銃|铳)
铴	(鐋|铴)
铵	(銨|铵)
银	(銀|银)
铷	(銣|铷)
铸	(鑄|鋳|铸)
铹	(鐒|铹)
铺	(鋪|舖|舗|铺)
铻	(鋙|铻)
铼	(錸|铼)
铽	(鋱|铽)
链	(鏈|链)
铿	(鏗|铿)
销	(銷|销)
锁	(鎖|鎻|鏁|锁)
锂	(鋰|锂)
锃	(鋥|锃)
锄	(鋤|耡|鉏|锄)
锅	(鍋|锅)
锆	(鋯|锆)
锇	(鋨|锇)
锈	(鏽|銹|鏥|锈)
锉	(銼|剉|锉)
锊	(鋝|锊)
锋	(鋒|锋)
锌	(鋅|锌)
锍	(鋶|锍)
锎	(鐦|锎)
锏	(鐧|锏)
锐	(銳|鋭|锐)
锑	(銻|锑)
锒	(鋃|锒)
锓	(鋟|锓)
锔	(鋦|锔)
锕	(錒|锕)
锖	(錆|锖)
锗	(鍺|锗)
锘	(鍩|锘)
错	(錯|错)
锚	(錨|锚)
锛	(錛|锛)
锜	(錡|锜)
锝	(鍀|锝)
锞	(錁|锞)
锟	(錕|锟)
锠	(錩|锠)
锡	(錫|钖|锡|鍚)
锢	(錮|锢)
锣	(鑼|锣)
锤	(錘|鎚|锤)
锥	(錐|锥)
锦	(錦|锦)
锧	(鑕|锧)
锨	(杴|锨)
锩	(錈|锩)
锪	(鍃|锪)
锫	(錇|锫)
锬	(錟|锬)
锭	(錠|锭)
键	(鍵|键)
锯	(鋸|锯)
锰	(錳|锰)
锱	(錙|锱)
锲	(鍥|锲)
锳	(鍈|锳)
锴	(鍇|锴)
锵	(鏘|锵)
锶	(鍶|锶)
锷	(鍔|锷)
锸	(鍤|锸)
锹	(鍬|鍫|锹)
锺	(鍾|鈡|鐘|钟|锺)
锻	(鍛|煅|锻)
锼	(鎪|锼)
锽	(鍠|锽)
锾	(鍰|鐶|锾|镮)
锿	(鎄|锿)
镀	(鍍|镀)
镁	(鎂|镁)
镂	(鏤|镂)
镃	(鎡|镃)
镄	(鐨|镄)
镅	(鎇|镅)
镆	(鏌|镆)
镇	(鎮|鎭|镇)
镈	(鎛|镈)
镉	(鎘|镉)
镊	(鑷|镊)
镋	(鎲|钂|镋)
镌	(鐫|鋑|鑴|镌)
镍	(鎳|镍)
镎	(鎿|镎)
镏	(鎦|镏)
镐	(鎬|镐)
镑	(鎊|镑)
镒	(鎰|镒)
镓	(鎵|镓)
镔	(鑌|镔)
镕	(鎔|熔|镕)
镖	(鏢|鑣|镖|镳)
镗	(鏜|镗)
镘	(鏝|镘)
镙	(鏍|镙)
镚	(錋|鏰|镚|斆|敩|斅|𢽾)
镛	(鏞|镛)
镜	(鏡|镜)
镝	(鏑|镝)
镞	(鏃|镞)
镟	(鏇|镟)
镠	(鏐|鎏|镠)
镡	(鐔|镡)
镢	(钁|镢)
镣	(鐐|镣)
镤	(鏷|镤)
镥	(鑥|镥)
镦	(鐓|镦)
镧	(鑭|镧)
镨	(鐠|镨)
镩	(鑹|镩)
镪	(鏹|镪)
镫	(鐙|镫)
镬	(鑊|镬)
镭	(鐳|镭)
镮	(鐶|鍰|镮|锾)
镯	(鐲|镯)
镰	(鐮|劆|鎌|镰)
镱	(鐿|镱)
镲	(鑔|镲)
镳	(鑣|鏢|镳|镖)
镴	(鑞|镴)
镵	(鑱|镵)
镶	(鑲|镶)
長	(长|長)
长	(長|长)
門	(门|門)
閂	(闩|閂)
閃	(闪|閃)
閆	(閻|闫|閆|阎)
閇	(閉|閇|闭)
閈	(闬|閈)
閉	(閇|闭|閉)
開	(开|幵|開)
閌	(闶|閌)
閍	(𨸂|閍)
閎	(闳|閎)
閏	(闰|閏)
閐	(𨸃|閐)
閑	(闲|閑)
閒	(間|閒|间)
間	(閒|间|間)
閔	(闵|閔)
閘	(闸|閘)
閙	(鬧|閙|闹)
閡	(阂|閡)
関	(闗|關|𨶹|関|关|寡)
閣	(阁|閣)
閤	(合|闔|阖|閤)
閥	(阀|閥)
閧	(哄|鬨|閧)
閨	(闺|閨)
閩	(闽|閩)
閫	(阃|閫)
閬	(阆|閬)
閭	(闾|閭|閭)
閱	(閲|阅|閱)
閲	(閱|閲|阅)
閶	(阊|閶)
閹	(剦|阉|閹)
閻	(閆|闫|阎|閻)
閼	(阏|閼)
閽	(阍|閽)
閾	(阈|閾)
閿	(阌|閿)
闃	(阒|闃)
闆	(板|版|闆)
闇	(暗|晻|闇)
闈	(闱|闈)
闊	(濶|阔|闊)
闋	(阕|闋)
闌	(阑|闌)
闍	(阇|闍)
闐	(阗|闐)
闒	(阘|闒)
闓	(闿|闓)
闔	(閤|阖|合|闔)
闕	(阙|闕)
闖	(闯|闖)
闗	(関|關|闗|𨶹|关|寡)
闘	(鬥|斗|闘|鬦|鬪|鬬|鬭)
關	(关|寡|関|闗|關|𨶹)
闞	(阚|闞)
闠	(阓|闠)
闡	(阐|闡)
闤	(阛|闤)
闥	(闼|闥)
门	(門|门)
闩	(閂|闩)
闪	(閃|闪)
闫	(閆|閻|闫|阎)
闬	(閈|闬)
闭	(閉|閇|闭)
问	(問|问)
闯	(闖|闯)
闰	(閏|闰)
闱	(闈|闱)
闲	(閑|闲)
闳	(閎|闳)
间	(間|閒|间)
闵	(閔|闵)
闶	(閌|闶)
闷	(悶|㥃|懣|闷|懑)
闸	(閘|闸)
闹	(鬧|閙|闹)
闺	(閨|闺)
闻	(聞|闻)
闼	(闥|闼)
闽	(閩|闽)
闾	(閭|闾|閭)
闿	(闓|闿)
阀	(閥|阀)
阁	(閣|阁)
阂	(閡|阂)
阃	(閫|阃)
阄	(鬮|䰗|阄)
阅	(閱|閲|阅)
阆	(閬|阆)
阇	(闍|阇)
阈	(閾|阈)
阉	(閹|剦|阉)
阊	(閶|阊)
阋	(鬩|阋)
阌	(閿|阌)
阍	(閽|阍)
阎	(閻|閆|闫|阎)
阏	(閼|阏)
阐	(闡|阐)
阑	(闌|阑)
阒	(闃|阒)
阓	(闠|阓)
阔	(闊|濶|阔)
阕	(闋|阕)
阖	(閤|闔|合|阖)
阗	(闐|阗)
阘	(闒|阘)
阙	(闕|阙)
阚	(闞|阚)
阛	(闤|阛)
阜	(阝|邑|阜)
阝	(邑|阜|阝)
队	(隊|队)
阡	(仟|千|阡)
阧	(陡|阧)
阨	(厄|呃|阸|戹|阨)
阪	(坂|阪)
阬	(坑|阬)
阮	(阮|阮)
阯	(址|阯)
阱	(汫|穽|阱)
阳	(氜|陽|阳|昜)
阴	(陰|阴|隂)
阵	(陣|阵|陳|𨸬|陈)
阶	(階|堦|阶)
阸	(阨|厄|呃|阸|戹)
阿	(啊|窕|阿)
陀	(陁|陀)
陁	(陀|陁)
际	(際|际)
陆	(陸|六|陆|陸|六)
陇	(隴|陇)
陈	(陳|陈|陣|阵|𨸬)
陉	(陘|陉)
陋	(陋|陋)
降	(夅|降|降)
陏	(隋|陏)
陔	(垓|陔)
陕	(陝|陕|陜|狹|狭)
陗	(峭|陗)
陘	(陉|陘)
陜	(狹|陝|狭|陜|陕)
陝	(陕|陜|陝|狹|狭)
陞	(升|昇|陞)
陡	(阧|陡)
陣	(阵|陳|𨸬|陣|陈)
陥	(陷|陥)
陧	(隉|陧)
陨	(隕|殒|殞|磒|陨)
险	(險|礆|险|険|硷|鹼|堿|碱|鹸|鹻)
陰	(阴|隂|陰)
陳	(陈|陣|陳|阵|𨸬)
陵	(陵|陵)
陶	(匋|陶)
陷	(陥|陷)
陸	(六|陆|陸|陸|六)
険	(險|礆|险|険|硷|鹼|堿|碱|鹸|鹻)
陻	(垔|堙|陻)
陼	(渚|陼)
陽	(昜|氜|阳|陽)
隂	(陰|阴|隂)
隄	(堤|隄)
隆	(隆|隆)
隈	(偎|渨|隈)
隉	(陧|隉)
隊	(队|隊)
隋	(陏|隋)
隍	(堭|隍)
階	(堦|阶|階)
随	(隨|随)
隐	(隠|隱|隐|乚)
隕	(殒|殞|磒|陨|隕)
隖	(塢|坞|鄔|隖|隝|邬)
隙	(郄|郤|隙)
際	(际|際)
隝	(塢|坞|鄔|隖|隝|邬)
隠	(隐|隱|隠|乚)
隣	(鄰|邻|隣|隣)
隤	(墤|𬯎|隤)
隧	(𡑞|隧)
隨	(随|隨)
隩	(𡒃|隩)
險	(礆|险|険|硷|險|鹼|堿|碱|鹸|鹻)
隮	(躋|跻|隮)
隱	(乚|隐|隠|隱)
隲	(騭|隲|骘)
隴	(陇|隴)
隶	(隸|隶|隷|隸)
隷	(隸|隶|隷|隸)
隸	(隶|隷|隸|隸)
隻	(只|子|止|祇|祗|隻)
隼	(鵻|鶽|隼)
隽	(雋|隽)
难	(難|难)
雁	(鳫|鴈|雁)
集	(亼|集)
雇	(僱|雇)
雋	(隽|雋)
雍	(邕|𪪝|雍|雝|廱|簌)
雏	(雛|雏|鶵)
雑	(雜|杂|襍|雑)
雕	(㓮|凋|彫|琱|鵰|雕)
雖	(虽|雖)
雙	(双|雙)
雛	(雏|鶵|雛)
雜	(杂|襍|雑|雜)
雝	(廱|簌|𪪝|雝|邕|雍)
雞	(鳮|鶏|鷄|鸡|雞)
雠	(仇|讎|讐|雠)
離	(离|離|離)
難	(难|難)
雨	(馭|御|雨|驭|禦)
雱	(霶|雱)
雲	(云|雲)
雳	(靂|雳)
零	(零|零)
雷	(雷|雷)
電	(电|電)
雾	(霧|雾)
霁	(霽|霁)
霊	(靈|灵|霊|靈)
霍	(癨|霍)
霓	(蜺|霓)
霜	(孀|霜)
霡	(霢|霡)
霢	(霡|霢)
霥	(濛|霥|靀)
霧	(雾|霧)
霭	(靄|霭)
霰	(䨘|霰)
露	(露|露)
霶	(雱|霶)
霸	(覇|霸)
霽	(霁|霽)
靀	(濛|霥|靀)
靂	(雳|靂)
靄	(霭|靄)
靆	(叇|靆)
靈	(灵|霊|靈|靈)
靉	(叆|靉)
靑	(青|靑)
青	(靑|青)
靓	(靚|靓|靜|静)
靔	(靝|天|靔)
靖	(靖|靖)
静	(靜|静|靚|靓)
靚	(靓|靜|靚|静)
靜	(静|靚|靜|靓)
靝	(天|靔|靝)
面	(麵|面|麪|麫|麺)
靥	(靨|靥)
靦	(腼|覥|靦|觍)
靧	(頮|靧|颒)
靨	(靥|靨)
靭	(韌|肕|靭|靱|韧)
靱	(韌|肕|靭|靱|韧)
靴	(鞾|靴)
鞀	(鞉|鼗|鞀)
鞉	(鞀|鼗|鞉)
鞋	(鞵|𩋘|𩋧|鞋)
鞌	(鞍|鞌)
鞍	(鞌|鞍)
鞏	(巩|鞏)
鞑	(韃|鞑)
鞒	(橇|鞽|鞒)
鞘	(韒|鞘)
鞙	(琄|鞙)
鞝	(绱|緔|鞝)
鞟	(鞹|鞟)
鞦	(鞧|鞦)
鞧	(鞦|鞧)
鞫	(諊|鞫)
鞯	(韉|鞯)
鞲	(韝|鞲)
鞴	(絥|鞴)
鞵	(鞋|鞵|𩋘|𩋧)
鞹	(鞟|鞹)
鞽	(橇|鞒|鞽)
鞾	(靴|鞾)
韁	(繮|缰|韁)
韂	(䩞|韂)
韃	(鞑|韃)
韈	(襪|韤|袜|韈)
韉	(鞯|韉)
韋	(韦|韋)
韌	(肕|靭|靱|韧|韌)
韍	(韨|韍)
韒	(鞘|韒)
韓	(韩|韓)
韙	(韪|韙)
韜	(弢|韬|韜)
韝	(鞲|韝)
韞	(縕|韫|緼|缊|韞)
韤	(襪|韈|袜|韤)
韦	(韋|韦)
韧	(韌|肕|靭|靱|韧)
韨	(韍|韨)
韩	(韓|韩)
韪	(韙|韪)
韫	(韞|縕|韫|緼|缊)
韬	(韜|弢|韬)
韭	(艽|韮|韭)
韮	(韭|艽|韮)
韲	(齏|韲|齑)
韵	(韻|韵)
韻	(韵|韻)
響	(响|響)
頁	(页|頁)
頂	(顶|𩠑|頂)
頃	(顷|頃)
項	(项|項)
順	(顺|順)
頇	(顸|頇)
須	(湏|须|須|鬚)
頉	(頤|頉|頣|颐)
頊	(顼|頊)
頋	(顧|頋|顾)
頌	(颂|頌)
頎	(颀|頎)
頏	(颃|頏)
預	(豫|预|予|預|余|餘|馀)
頑	(顽|頑)
頒	(朌|颁|頒)
頓	(顿|頓)
頗	(颇|頗)
領	(领|領|領)
頚	(頸|頚|颈)
頜	(颌|頜)
頟	(額|頟|额)
頡	(颉|頡)
頣	(頤|頉|頣|颐)
頤	(頉|頣|颐|頤)
頦	(颏|頦)
頫	(俯|頫)
頬	(頰|頬|颊)
頭	(头|頭)
頮	(靧|颒|頮)
頰	(頬|颊|頰)
頲	(颋|頲)
頴	(穎|颕|署|頴|颖)
頷	(颔|頷)
頸	(頚|颈|頸)
頹	(頽|颓|頹)
頻	(频|頻)
頼	(賴|赖|頼)
頽	(頹|頽|颓)
顃	(𩖖|顃)
顆	(颗|顆)
顋	(腮|顋)
題	(题|題)
額	(頟|额|額)
顎	(颚|顎)
顏	(顔|颜|顏)
顒	(颙|顒)
顓	(颛|顓)
顔	(顏|顔|颜)
顕	(顯|显|顕)
顖	(囟|䪿|倖|幸|顖)
願	(愿|𫖸|願)
顙	(颡|顙)
顚	(顛|顚|颠)
顛	(顚|颠|顛)
類	(类|類|𩔗|類)
顢	(颟|顢)
顥	(皓|皝|颢|顥)
顦	(憔|顦)
顧	(頋|顾|顧)
顫	(颤|顫)
顬	(颥|顬)
顯	(显|顕|顯)
顰	(嚬|颦|顰)
顱	(颅|髗|顱|臚|胪)
顳	(颞|顳)
顴	(颧|顴)
页	(頁|页)
顶	(頂|顶|𩠑)
顷	(頃|顷)
顸	(頇|顸)
项	(項|项)
顺	(順|顺)
须	(須|鬚|湏|须)
顼	(頊|顼)
顽	(頑|顽)
顾	(顧|頋|顾)
顿	(頓|顿)
颀	(頎|颀)
颁	(頒|朌|颁)
颂	(頌|颂)
颃	(頏|颃)
预	(預|豫|预|予|余|餘|馀)
颅	(顱|颅|髗|臚|胪)
领	(領|领|領)
颇	(頗|颇)
颈	(頸|頚|颈)
颉	(頡|颉)
颊	(頰|頬|颊)
颋	(頲|颋)
颌	(頜|颌)
颍	(潁|颍)
颎	(熲|颎)
颏	(頦|颏)
颐	(頤|頉|頣|颐)
频	(頻|频)
颒	(頮|靧|颒)
颓	(頹|頽|颓)
颔	(頷|颔)
颕	(頴|穎|颕|署|颖)
颖	(穎|署|頴|颖|颕)
颗	(顆|颗)
题	(題|题)
颙	(顒|颙)
颚	(顎|颚)
颛	(顓|颛)
颜	(顏|顔|颜)
额	(額|頟|额)
颞	(顳|颞)
颟	(顢|颟)
颠	(顛|顚|颠)
颡	(顙|颡)
颢	(顥|皓|皝|颢)
颣	(纇|颣)
颤	(顫|颤)
颥	(顬|颥)
颦	(顰|嚬|颦)
颧	(顴|颧)
風	(凨|风|風)
颭	(飐|颭)
颮	(猋|飇|飑|颮)
颯	(飒|颯)
颰	(𩙥|颰)
颱	(台|檯|臺|颱|儓|枱)
颳	(刮|颳)
颶	(飓|颶)
颷	(𩙪|颷)
颸	(飔|颸)
颺	(飏|颺)
颻	(飖|颻)
颼	(䬒|飕|颼)
颾	(𩙫|颾)
飀	(飗|飀)
飃	(飄|飃|飘)
飄	(飃|飘|飄)
飆	(飙|飆)
飇	(猋|颮|飇|飑)
飈	(飚|飈)
风	(風|凨|风)
飏	(颺|飏)
飐	(颭|飐)
飑	(颮|猋|飇|飑)
飒	(颯|飒)
飓	(颶|飓)
飔	(颸|飔)
飕	(颼|䬒|飕)
飖	(颻|飖)
飗	(飀|飗)
飘	(飄|飃|飘)
飙	(飆|飙)
飚	(飈|飚)
飛	(飞|飛)
飜	(翻|繙|飜)
飞	(飛|飞)
食	(飠|饣|食)
飠	(食|饣|飠)
飡	(餐|喰|飡)
飢	(饑|饥|飢)
飣	(饤|飣)
飤	(飼|飤|饲|飼)
飥	(饦|飥)
飦	(饘|飦|𫗴)
飨	(饗|飨)
飩	(饨|飩)
飪	(䏕|餁|饪|飪)
飫	(饇|饫|飫)
飭	(饬|飭)
飮	(飲|饮|飮)
飯	(飰|饭|飯|飯)
飰	(飯|飰|饭|飯)
飲	(飮|饮|飲)
飴	(饴|飴)
飼	(飤|饲|飼|飼)
飽	(饱|飽)
飾	(餙|餝|饰|飾)
飿	(饳|飿)
餁	(飪|䏕|餁|饪)
餂	(舔|餂)
餃	(饺|餃)
餄	(饸|餄)
餅	(餠|饼|餅)
餉	(饟|饷|餉)
養	(养|養)
餌	(饵|餌)
餍	(饜|餍)
餎	(饹|餎)
餏	(饻|餏)
餐	(喰|飡|餐)
餑	(饽|餑)
餒	(餧|馁|喂|餒|餵|諉|诿)
餓	(饿|餓)
餔	(𫗦|餔)
餕	(馂|餕)
餖	(饾|餖)
餗	(𫗧|餗)
餘	(余|馀|予|餘|豫|預|预)
餙	(飾|餙|餝|饰)
餚	(肴|餚)
餛	(餫|馄|餛)
餜	(䴹|馃|餜)
餝	(飾|餙|餝|饰)
餞	(饯|餞)
餟	(醊|餟)
餠	(餅|餠|饼)
餡	(馅|餡)
餦	(𫗠|餦)
餧	(喂|餒|餧|餵|馁|諉|诿)
館	(舘|馆|館|館)
餫	(餛|餫|馄)
餭	(𫗮|餭)
餱	(糇|餱)
餳	(饧|餳)
餵	(喂|諉|餧|餵|诿|餒|馁)
餶	(馉|餶)
餷	(馇|餷)
餸	(𩠌|餸)
餹	(糖|餹|糖)
餺	(馎|餺)
餻	(糕|餻)
餼	(饩|餼)
餽	(饋|馈|匱|櫃|餽|匮|樻|鐀|柜)
餾	(馏|餾)
餿	(馊|餿)
饁	(馌|饁)
饃	(馍|饃)
饅	(馒|饅)
饇	(飫|饇|饫)
饈	(䐰|馐|𦟤|饈)
饉	(馑|饉)
饊	(糤|馓|饊)
饋	(匱|櫃|餽|馈|匮|樻|鐀|饋|柜)
饌	(䉵|籑|馔|饌)
饍	(膳|饍)
饑	(飢|饑|饥)
饒	(饶|饒)
饕	(叨|饕)
饗	(飨|饗)
饘	(飦|𫗴|饘)
饜	(餍|饜)
饞	(嚵|馋|饞)
饟	(餉|饟|饷)
饢	(馕|饢)
饣	(食|飠|饣)
饤	(飣|饤)
饥	(飢|饑|饥)
饦	(飥|饦)
饧	(餳|饧)
饨	(飩|饨)
饩	(餼|饩)
饪	(飪|䏕|餁|饪)
饫	(飫|饇|饫)
饬	(飭|饬)
饭	(飯|飰|饭|飯)
饮	(飮|飲|饮)
饯	(餞|饯)
饰	(飾|餙|餝|饰)
饱	(飽|饱)
饲	(飼|飤|饲|飼)
饳	(飿|饳)
饴	(飴|饴)
饵	(餌|饵)
饶	(饒|饶)
饷	(餉|饟|饷)
饸	(餄|饸)
饹	(餎|饹)
饺	(餃|饺)
饻	(餏|饻)
饼	(餅|餠|饼)
饽	(餑|饽)
饾	(餖|饾)
饿	(餓|饿)
馀	(餘|余|馀|予|豫|預|预)
馁	(餒|餧|馁|喂|餵|諉|诿)
馂	(餕|馂)
馃	(餜|䴹|馃)
馄	(餛|餫|馄)
馅	(餡|馅)
馆	(館|舘|馆|館)
馇	(餷|馇)
馈	(餽|饋|馈|匱|櫃|匮|樻|鐀|柜)
馉	(餶|馉)
馊	(餿|馊)
馋	(饞|嚵|馋)
馌	(饁|馌)
馍	(饃|馍)
馎	(餺|馎)
馏	(餾|馏)
馐	(饈|䐰|馐|𦟤)
馑	(饉|馑)
馒	(饅|馒)
馓	(糤|饊|馓)
馔	(饌|䉵|籑|馔)
馕	(饢|馕)
馘	(聝|馘)
馚	(馩|馚)
馩	(馚|馩)
馬	(马|馬)
馭	(御|雨|驭|禦|馭)
馮	(冯|馮)
馱	(䭾|駄|驮|馱)
馳	(驰|馳)
馴	(驯|馴)
馹	(驲|馹)
馿	(驢|馿|驴)
駁	(駮|驳|駁)
駃	(𫘝|駃)
駄	(馱|䭾|駄|驮)
駅	(驛|駅|驿)
駆	(驅|敺|駆|駈|驱)
駈	(驅|敺|駆|駈|驱)
駎	(𩧨|駎)
駐	(驻|駐)
駑	(驽|駑)
駒	(驹|駒)
駔	(驵|駔)
駕	(驾|駕)
駘	(骀|駘)
駙	(驸|駙)
駚	(𩧫|駚)
駛	(驶|𩢲|駛)
駝	(駞|驼|駝)
駞	(駝|駞|驼)
駟	(驷|駟)
駡	(罵|傌|駡|骂)
駢	(騈|骈|駢)
駦	(騰|腾|駦)
駧	(𩧲|駧)
駩	(𩧴|駩)
駪	(侁|詵|駪|诜)
駭	(骇|駭)
駮	(駁|駮|驳)
駰	(骃|駰)
駱	(骆|駱|駱)
駶	(𩧺|駶)
駸	(骎|駸)
駻	(𫘣|駻)
駿	(骏|駿)
騁	(骋|騁)
騂	(骍|騂)
騃	(呆|𫘤|獃|騃)
騅	(骓|騅)
騈	(駢|騈|骈)
騌	(騣|骔|鬃|騌)
騍	(骒|騍)
騎	(骑|騎)
騏	(骐|騏)
騐	(驗|騐|験|验)
騒	(騷|騒|骚)
験	(驗|騐|験|验)
騔	(𩨀|騔)
騖	(骛|騖)
騗	(騙|騗|骗)
騘	(驄|騘|骢)
騙	(騗|骗|騙)
騚	(𩨊|騚)
騝	(𩨃|騝)
騟	(𩨈|騟)
騠	(𫘨|騠)
騣	(騌|鬃|騣|骔)
騤	(骙|騤)
騧	(䯄|騧)
騨	(驒|騨)
騪	(𩨄|騪)
騫	(骞|騫)
騭	(隲|骘|騭)
騮	(骝|騮)
騰	(腾|駦|騰)
騶	(驺|騶)
騷	(騒|骚|騷)
騸	(骟|騸)
騺	(驇|騺)
騾	(驘|骡|騾)
驀	(蓦|驀)
驁	(骜|驁)
驂	(骖|驂)
驃	(骠|驃)
驄	(騘|骢|驄)
驅	(敺|駆|駈|驱|驅)
驇	(騺|驇)
驊	(骅|𦽊|驊)
驋	(𩧯|驋)
驌	(骕|驌)
驍	(骁|驍)
驏	(骣|驏)
驒	(騨|驒)
驕	(骄|驕)
驗	(騐|験|验|驗)
驘	(騾|驘|骡)
驚	(惊|驚)
驛	(駅|驿|驛)
驟	(骤|驟)
驢	(馿|驴|驢)
驤	(骧|驤)
驥	(骥|驥)
驦	(骦|驦)
驩	(歡|懽|欢|歓|讙|驩)
驪	(骊|驪|驪)
驫	(骉|驫)
马	(馬|马)
驭	(馭|御|雨|驭|禦)
驮	(馱|䭾|駄|驮)
驯	(馴|驯)
驰	(馳|驰)
驱	(驅|敺|駆|駈|驱)
驲	(馹|驲)
驳	(駁|駮|驳)
驴	(驢|馿|驴)
驵	(駔|驵)
驶	(駛|驶|𩢲)
驷	(駟|驷)
驸	(駙|驸)
驹	(駒|驹)
驺	(騶|驺)
驻	(駐|驻)
驼	(駝|駞|驼)
驽	(駑|驽)
驾	(駕|驾)
驿	(驛|駅|驿)
骀	(駘|骀)
骁	(驍|骁)
骂	(罵|傌|駡|骂)
骃	(駰|骃)
骄	(驕|骄)
骅	(驊|骅|𦽊)
骆	(駱|骆|駱)
骇	(駭|骇)
骈	(駢|騈|骈)
骉	(驫|骉)
骊	(驪|骊|驪)
骋	(騁|骋)
验	(驗|騐|験|验)
骍	(騂|骍)
骎	(駸|骎)
骏	(駿|骏)
骐	(騏|骐)
骑	(騎|骑)
骒	(騍|骒)
骓	(騅|骓)
骔	(騌|鬃|騣|骔)
骕	(驌|骕)
骖	(驂|骖)
骗	(騙|騗|骗)
骘	(騭|隲|骘)
骙	(騤|骙)
骚	(騷|騒|骚)
骛	(騖|骛)
骜	(驁|骜)
骝	(騮|骝)
骞	(騫|骞)
骟	(騸|骟)
骠	(驃|骠)
骡	(騾|驘|骡)
骢	(驄|騘|骢)
骣	(驏|骣)
骤	(驟|骤)
骥	(驥|骥)
骦	(驦|骦)
骧	(驤|骧)
骪	(骫|骪)
骫	(骪|骫)
骯	(肮|腌|骯|醃)
骴	(胔|𦙼|骴)
骵	(體|体|躰|軆|骵)
骻	(胯|骻)
骽	(腿|骽)
骾	(挭|鯁|骾|鲠)
髃	(腢|髃)
髄	(髓|膸|髄)
髅	(髏|髅)
髋	(髖|髋)
髌	(臏|髕|膑|髌)
髏	(髅|髏)
髒	(脏|臟|髒|臓)
髓	(膸|髄|髓)
體	(体|躰|軆|骵|體)
髕	(臏|髌|膑|髕)
髖	(髋|髖)
髗	(臚|顱|胪|髗|颅)
高	(髙|高)
髙	(高|髙)
髣	(仿|彷|倣|髣|徬)
髥	(髯|髥)
髦	(犛|氂|牦|髦)
髪	(髮|发|髪|發|彂|発)
髮	(发|髪|發|髮|彂|発)
髯	(髥|髯)
髴	(彿|髴)
髻	(䯻|髻)
髼	(鬅|髼)
鬀	(剃|鬀)
鬂	(鬢|鬂|鬓|𩯭)
鬃	(騌|騣|骔|鬃)
鬅	(髼|鬅)
鬆	(松|枀|枩|鬆)
鬍	(胡|楜|糊|葫|蝴|衚|鬍)
鬒	(㐱|鬒)
鬓	(鬢|𩯭|鬂|鬓)
鬚	(须|須|鬚|湏)
鬢	(鬂|鬓|鬢|𩯭)
鬣	(巤|剌|鬣)
鬥	(斗|闘|鬦|鬪|鬬|鬭|鬥)
鬦	(鬥|斗|闘|鬦|鬪|鬬|鬭)
鬧	(閙|闹|鬧)
鬨	(哄|閧|鬨)
鬩	(阋|鬩)
鬪	(鬥|鬬|斗|闘|鬦|鬪|鬭)
鬬	(鬥|鬪|斗|闘|鬦|鬬|鬭)
鬭	(鬥|斗|闘|鬦|鬪|鬬|鬭)
鬮	(䰗|阄|鬮)
鬰	(鬱|欝|郁|鬰|喐)
鬱	(欝|郁|鬰|鬱|喐)
鬶	(鬹|鬶)
鬹	(鬶|鬹)
鬻	(粥|鬻)
魇	(魘|魇)
魉	(魎|魉)
魎	(魉|魎)
魏	(巍|魏)
魘	(魇|魘)
魙	(聻|魙)
魚	(鱼|魚)
魛	(鱽|魛)
魟	(鰩|𫚉|魟|鳐)
魢	(鱾|魢)
魥	(𩽹|魥)
魦	(鯊|魦|鯋|鲨)
魨	(鲀|魨)
魯	(鲁|魯|魯)
魴	(鲂|魴)
魷	(鰌|鱿|䲡|魷|鰍|鳅)
魺	(鲄|魺)
鮁	(鲅|鮁)
鮃	(鲆|鮃)
鮄	(𫚒|鮄)
鮊	(鲌|鮊)
鮋	(鲉|鮋)
鮍	(鲏|鮍)
鮐	(鲐|鮐)
鮑	(鲍|鮑)
鮒	(鲋|鮒)
鮓	(鲊|鮓)
鮚	(鲒|鮚)
鮜	(鲘|鮜)
鮝	(鯗|鮝|鲞)
鮞	(鲕|鮞)
鮟	(𩽾|鮟)
鮣	(䲟|鮣)
鮦	(鲖|鮦)
鮧	(鯷|鮧|鳀)
鮪	(鲔|鮪)
鮫	(鲛|鮫)
鮭	(鲑|鮭)
鮮	(尟|尠|鱻|鲜|鮮)
鮰	(𫚔|鮰)
鮳	(鲓|鮳)
鮶	(鲪|鮶)
鮸	(𩾃|鮸)
鮺	(鲝|鮺)
鯀	(鲧|鯀)
鯁	(挭|骾|鲠|鯁)
鯄	(𩾁|鯄)
鯆	(𫚙|鯆)
鯇	(鲩|鯇)
鯉	(鲤|鯉)
鯊	(魦|鯋|鲨|鯊)
鯋	(鯊|魦|鯋|鲨)
鯒	(鲬|鯒)
鯔	(鲻|鯔)
鯕	(鲯|鯕)
鯖	(鲭|鯖)
鯗	(鮝|鲞|鯗)
鯛	(鲷|鯛)
鯝	(鲴|鯝)
鯡	(鲱|鯡)
鯢	(鲵|鯢)
鯤	(鲲|鯤)
鯧	(䱽|鲳|䲝|鯧)
鯨	(鲸|鯨)
鯪	(鲮|鯪)
鯫	(鲰|鯫)
鯱	(𩾇|鯱)
鯴	(鲺|鯴)
鯶	(𩽼|鯶)
鯷	(鮧|鳀|鯷)
鯽	(鲫|鯽)
鯿	(鳊|鯿)
鰁	(鳈|鰁)
鰂	(鲗|鰂)
鰃	(鳂|鰃)
鰆	(䲠|鰆)
鰈	(鲽|鰈)
鰉	(鱑|鳇|鰉)
鰌	(䲡|魷|鰍|鰌|鱿|鳅)
鰍	(鰌|鳅|䲡|魷|鰍|鱿)
鰏	(鲾|鰏)
鰐	(鱷|鰐|鳄)
鰒	(鳆|鰒)
鰓	(鳃|鰓)
鰕	(蝦|虾|鰕)
鰛	(鳁|鰛|鰮)
鰜	(鳒|鰜)
鰟	(鳑|鰟)
鰠	(鳋|鰠)
鰣	(鲥|鰣)
鰤	(𫚕|鰤)
鰥	(鳏|鰥)
鰧	(䲢|鰧)
鰨	(鳎|鰨)
鰩	(魟|鳐|鰩|𫚉)
鰭	(鳍|鰭)
鰮	(鳁|鰛|鰮)
鰱	(鲢|鰱)
鰲	(鳌|鼇|鰲)
鰳	(鳓|鰳)
鰵	(鳘|鰵)
鰷	(鲦|鰷)
鰹	(鲣|鰹)
鰺	(鲹|鰺)
鰻	(鳗|鰻)
鰼	(鳛|鰼)
鰾	(鳔|鰾)
鱂	(鳉|鱂)
鱅	(鳙|鱅)
鱇	(𩾌|鱇)
鱈	(鳕|鱈)
鱉	(鳖|鼈|龞|鱉)
鱑	(鰉|鱑|鳇)
鱒	(鳟|鱒)
鱓	(䱇|鱔|鱓|鳝)
鱔	(鱓|鳝|䱇|鱔)
鱖	(鳜|鱖)
鱗	(鳞|鱗|鱗)
鱘	(鲟|鱘)
鱝	(鲼|鱝)
鱟	(鲎|鱟)
鱠	(膾|鲙|脍|鱠)
鱣	(鳣|鱣)
鱤	(鳡|鱤)
鱧	(鳢|鱧)
鱨	(鲿|鱨)
鱭	(鲚|鱭)
鱮	(𫚈|鱮)
鱯	(鳠|鱯)
鱲	(𫚭|鱲)
鱷	(鰐|鳄|鱷)
鱸	(鲈|鱸)
鱺	(鲡|鱺)
鱻	(鮮|尟|尠|鱻|鲜)
鱼	(魚|鱼)
鱽	(魛|鱽)
鱾	(魢|鱾)
鱿	(魷|鰌|鱿|䲡|鰍|鳅)
鲀	(魨|鲀)
鲁	(魯|鲁|魯)
鲂	(魴|鲂)
鲃	(䰾|鲃)
鲄	(魺|鲄)
鲅	(鮁|鲅)
鲆	(鮃|鲆)
鲈	(鱸|鲈)
鲉	(鮋|鲉)
鲊	(鮓|鲊)
鲋	(鮒|鲋)
鲌	(鮊|鲌)
鲍	(鮑|鲍)
鲎	(鱟|鲎)
鲏	(鮍|鲏)
鲐	(鮐|鲐)
鲑	(鮭|鲑)
鲒	(鮚|鲒)
鲓	(鮳|鲓)
鲔	(鮪|鲔)
鲕	(鮞|鲕)
鲖	(鮦|鲖)
鲗	(鰂|鲗)
鲘	(鮜|鲘)
鲙	(鱠|膾|鲙|脍)
鲚	(鱭|鲚)
鲛	(鮫|鲛)
鲜	(鮮|尟|尠|鱻|鲜)
鲝	(鮺|鲝)
鲞	(鯗|鮝|鲞)
鲟	(鱘|鲟)
鲠	(鯁|挭|骾|鲠)
鲡	(鱺|鲡)
鲢	(鰱|鲢)
鲣	(鰹|鲣)
鲤	(鯉|鲤)
鲥	(鰣|鲥)
鲦	(鰷|鲦)
鲧	(鯀|鲧)
鲨	(鯊|魦|鯋|鲨)
鲩	(鯇|鲩)
鲪	(鮶|鲪)
鲫	(鯽|鲫)
鲬	(鯒|鲬)
鲭	(鯖|鲭)
鲮	(鯪|鲮)
鲯	(鯕|鲯)
鲰	(鯫|鲰)
鲱	(鯡|鲱)
鲲	(鯤|鲲)
鲳	(鯧|䱽|鲳|䲝)
鲴	(鯝|鲴)
鲵	(鯢|鲵)
鲷	(鯛|鲷)
鲸	(鯨|鲸)
鲹	(鰺|鲹)
鲺	(鯴|鲺)
鲻	(鯔|鲻)
鲼	(鱝|鲼)
鲽	(鰈|鲽)
鲾	(鰏|鲾)
鲿	(鱨|鲿)
鳀	(鯷|鮧|鳀)
鳁	(鰛|鰮|鳁)
鳂	(鰃|鳂)
鳃	(鰓|鳃)
鳄	(鱷|鰐|鳄)
鳅	(鰍|鰌|鳅|䲡|魷|鱿)
鳆	(鰒|鳆)
鳇	(鰉|鱑|鳇)
鳈	(鰁|鳈)
鳉	(鱂|鳉)
鳊	(鯿|鳊)
鳋	(鰠|鳋)
鳌	(鰲|鳌|鼇)
鳍	(鰭|鳍)
鳎	(鰨|鳎)
鳏	(鰥|鳏)
鳐	(鰩|魟|鳐|𫚉)
鳑	(鰟|鳑)
鳒	(鰜|鳒)
鳓	(鰳|鳓)
鳔	(鰾|鳔)
鳕	(鱈|鳕)
鳖	(鱉|鳖|鼈|龞)
鳗	(鰻|鳗)
鳘	(鰵|鳘)
鳙	(鱅|鳙)
鳚	(䲁|鳚)
鳛	(鰼|鳛)
鳜	(鱖|鳜)
鳝	(鱔|鱓|鳝|䱇)
鳞	(鱗|鳞|鱗)
鳟	(鱒|鳟)
鳠	(鱯|鳠)
鳡	(鱤|鳡)
鳢	(鱧|鳢)
鳣	(鱣|鳣)
鳥	(鸟|鳥)
鳧	(凫|鳧)
鳩	(鸠|鳩)
鳫	(雁|鳫|鴈)
鳮	(雞|鷄|鳮|鶏|鸡)
鳯	(鳳|凤|鳯)
鳲	(鸤|鳲)
鳳	(凤|鳯|鳳)
鳴	(鸣|鳴)
鳶	(鸢|鳶)
鳷	(𫛛|鳷)
鳼	(𪉃|鳼)
鳾	(䴓|鳾)
鴃	(鵙|𫛞|鴃)
鴄	(裒|鴄)
鴆	(酖|鸩|鴆)
鴇	(鸨|鴇)
鴈	(雁|鳫|鴈)
鴉	(鵶|鸦|鴉)
鴎	(鷗|鴎|鸥)
鴒	(鸰|鴒)
鴕	(鸵|鴕)
鴗	(𫁡|鴗)
鴛	(鸳|鴛)
鴜	(𪉈|鴜)
鴝	(朐|鸜|鸲|胊|鴝)
鴞	(梟|鸮|枭|鴞)
鴟	(鸱|鴟)
鴣	(鸪|鴣)
鴦	(鸯|鴦)
鴨	(鸭|鴨)
鴬	(鶯|莺|鴬|鸎)
鴯	(鸸|鴯)
鴰	(鸹|鴰)
鴲	(𪉆|鴲)
鴳	(鷃|鴳)
鴴	(鸻|鴴)
鴷	(䴕|鴷)
鴺	(鵜|鴺|鹈)
鴻	(鸿|鴻)
鴿	(鸽|鴿)
鵁	(䴔|鵁)
鵂	(鸺|鵂)
鵃	(鸼|鵃)
鵉	(鸞|鵉|鸾|鸞)
鵐	(鹀|鵐)
鵑	(鹃|鵑)
鵒	(鹆|鵒)
鵓	(鹁|鵓)
鵙	(鴃|鵙|𫛞)
鵚	(𪉍|鵚)
鵜	(鴺|鹈|鵜)
鵝	(鵞|鹅|鵝)
鵞	(鵝|鵞|鹅)
鵠	(鹄|鵠)
鵡	(鹉|鵡)
鵪	(鹌|鵪)
鵬	(鹏|鵬)
鵮	(鹐|鵮)
鵯	(鹎|鵯)
鵰	(彫|雕|㓮|鵰|凋|琱)
鵲	(鹊|鵲)
鵶	(鴉|鵶|鸦)
鵷	(鹓|鵷)
鵻	(隼|鵻|鶽)
鵾	(鹍|鵾)
鶂	(鶃|鶂)
鶃	(鶂|鶃)
鶄	(䴖|鶄)
鶇	(鸫|鶇)
鶉	(鹑|鶉)
鶊	(鹒|鶊)
鶏	(雞|鳮|鶏|鷄|鸡)
鶒	(𫛶|鶒)
鶓	(鹋|鶓)
鶖	(鹙|鶖)
鶗	(𫛸|鶗)
鶘	(鹕|鶘)
鶚	(鹗|鶚)
鶡	(鹖|鶡)
鶥	(鹛|鶥)
鶩	(鹜|鶩)
鶪	(䴗|鶪)
鶬	(鸧|鶬)
鶯	(莺|鴬|鸎|鶯)
鶱	(𬸣|鶱)
鶲	(鹟|鶲)
鶴	(鹤|鶴|鶴)
鶵	(雛|雏|鶵)
鶹	(鹠|鶹)
鶺	(鹡|鶺)
鶻	(鹘|鶻)
鶼	(鹣|鶼)
鶽	(隼|鵻|鶽)
鶿	(鹚|鶿)
鷁	(鹢|鷁)
鷂	(鹞|鷂)
鷃	(鴳|鷃)
鷄	(雞|鳮|鶏|鷄|鸡)
鷆	(鷏|鷆)
鷈	(䴘|鷈)
鷊	(鹝|鷊)
鷏	(鷆|鷏)
鷓	(鹧|鷓)
鷔	(𪉑|鷔)
鷖	(鹥|鷖)
鷗	(鴎|鸥|鷗)
鷙	(鸷|鷙)
鷚	(鹨|鷚)
鷥	(鸶|鷥)
鷦	(鹪|鷦)
鷨	(𪉊|鷨)
鷩	(氅|鷩)
鷫	(鹔|鷫)
鷯	(鹩|鷯)
鷰	(燕|讌|醼|鷰|䜩|宴)
鷲	(鹫|鷲)
鷳	(鹇|鷳)
鷸	(鹬|鷸)
鷹	(鹰|鷹)
鷺	(鹭|鷺|鷺)
鷽	(鸴|鷽)
鷿	(䴙|鷿)
鸂	(㶉|鸂)
鸇	(鹯|鸇)
鸋	(𫛢|鸋)
鸌	(鹱|鸌)
鸎	(鶯|莺|鴬|鸎)
鸏	(鹲|鸏)
鸕	(鸬|鸕)
鸘	(鹴|鸘)
鸚	(鹦|鸚)
鸛	(鹳|鸛)
鸜	(朐|鴝|胊|鸜|鸲)
鸝	(鹂|鸝)
鸞	(鵉|鸾|鸞|鸞)
鸟	(鳥|鸟)
鸠	(鳩|鸠)
鸡	(雞|鳮|鶏|鷄|鸡)
鸢	(鳶|鸢)
鸣	(鳴|鸣)
鸤	(鳲|鸤)
鸥	(鷗|鴎|鸥)
鸦	(鴉|鵶|鸦)
鸧	(鶬|鸧)
鸨	(鴇|鸨)
鸩	(鴆|酖|鸩)
鸪	(鴣|鸪)
鸫	(鶇|鸫)
鸬	(鸕|鸬)
鸭	(鴨|鸭)
鸮	(鴞|梟|鸮|枭)
鸯	(鴦|鸯)
鸰	(鴒|鸰)
鸱	(鴟|鸱)
鸲	(鴝|朐|鸜|鸲|胊)
鸳	(鴛|鸳)
鸴	(鷽|鸴)
鸵	(鴕|鸵)
鸶	(鷥|鸶)
鸷	(鷙|鸷)
鸸	(鴯|鸸)
鸹	(鴰|鸹)
鸺	(鵂|鸺)
鸻	(鴴|鸻)
鸼	(鵃|鸼)
鸽	(鴿|鸽)
鸾	(鸞|鵉|鸾|鸞)
鸿	(鴻|鸿)
鹀	(鵐|鹀)
鹁	(鵓|鹁)
鹂	(鸝|鹂)
鹃	(鵑|鹃)
鹄	(鵠|鹄)
鹅	(鵝|鵞|鹅)
鹆	(鵒|鹆)
鹇	(鷳|鹇)
鹈	(鵜|鴺|鹈)
鹉	(鵡|鹉)
鹊	(鵲|鹊)
鹋	(鶓|鹋)
鹌	(鵪|鹌)
鹍	(鵾|鹍)
鹎	(鵯|鹎)
鹏	(鵬|鹏)
鹐	(鵮|鹐)
鹑	(鶉|鹑)
鹒	(鶊|鹒)
鹓	(鵷|鹓)
鹔	(鷫|鹔)
鹕	(鶘|鹕)
鹖	(鶡|鹖)
鹗	(鶚|鹗)
鹘	(鶻|鹘)
鹙	(鶖|鹙)
鹚	(鶿|鹚)
鹛	(鶥|鹛)
鹜	(鶩|鹜)
鹝	(鷊|鹝)
鹞	(鷂|鹞)
鹟	(鶲|鹟)
鹠	(鶹|鹠)
鹡	(鶺|鹡)
鹢	(鷁|鹢)
鹣	(鶼|鹣)
鹤	(鶴|鹤|鶴)
鹥	(鷖|鹥)
鹦	(鸚|鹦)
鹧	(鷓|鹧)
鹨	(鷚|鹨)
鹩	(鷯|鹩)
鹪	(鷦|鹪)
鹫	(鷲|鹫)
鹬	(鷸|鹬)
鹭	(鷺|鹭|鷺)
鹮	(䴉|鹮)
鹯	(鸇|鹯)
鹰	(鷹|鹰)
鹱	(鸌|鹱)
鹲	(鸏|鹲)
鹳	(鸛|鹳)
鹴	(鸘|鹴)
鹵	(卤|鹵)
鹸	(鹼|堿|硷|碱|鹸|鹻|礆|險|险|険)
鹹	(咸|鹹)
鹺	(鹾|鹺)
鹻	(堿|碱|鹼|鹻|硷|鹸|礆|險|险|険)
鹼	(堿|硷|碱|鹸|鹻|鹼|礆|險|险|険)
鹽	(䀋|塩|盐|𥂁|鹽)
鹾	(鹺|鹾)
鹿	(鹿|鹿)
麁	(粗|觕|麁|麄|麤)
麄	(粗|觕|麤|麁|麄)
麇	(麕|麇)
麐	(麟|麐|麟)
麓	(梺|麓)
麕	(麇|麕)
麗	(丽|麗|麗)
麞	(獐|麞)
麟	(麐|麟|麟)
麤	(粗|觕|麄|麁|麤)
麥	(麦|麥)
麦	(麥|麦)
麨	(𪎊|麨)
麩	(麸|麩)
麪	(麵|面|麪|麫|麺)
麫	(麵|面|麪|麫|麺)
麯	(麴|麯|麹)
麰	(牟|麰)
麲	(𪎉|麲)
麴	(麯|麹|麴)
麵	(面|麪|麫|麺|麵)
麸	(麩|麸)
麹	(麴|麯|麹)
麺	(麵|面|麪|麫|麺)
麻	(菻|蔴|麻)
麼	(么|庅|麽|幺|麼)
麽	(么|庅|麼|幺|麽)
黃	(黄|黃)
黄	(黃|黄)
黉	(黌|黉)
黌	(黉|黌)
黎	(黎|黎)
黏	(粘|黏)
黑	(黒|黑)
黒	(黑|黒)
默	(嘿|黙|默)
黙	(默|嘿|黙)
點	(奌|点|點)
黡	(黶|黡)
黨	(党|黨)
黩	(黷|黩)
黪	(黲|黪)
黲	(黪|黲)
黶	(黡|黶)
黷	(黩|黷)
黽	(黾|黽)
黾	(黽|黾)
黿	(鼋|黿)
鼂	(鼌|鼂)
鼃	(蛙|鼃)
鼄	(蛛|鼄)
鼅	(蜘|鼅)
鼇	(鰲|鳌|鼇)
鼈	(鱉|鳖|鼈|龞)
鼉	(鼍|鼉)
鼋	(黿|鼋)
鼌	(鼂|鼌)
鼍	(鼉|鼍)
鼎	(𪔂|鼎)
鼏	(冪|幂|羃|鼏)
鼓	(皷|皼|鼔|鼓)
鼔	(皷|鼓|鼔|皼)
鼕	(冬|鼕)
鼗	(鞀|鞉|鼗)
鼠	(鼡|鼠)
鼡	(鼠|鼡)
鼴	(鼹|鼴)
鼹	(鼴|鼹)
齁	(𪖙|齁)
齅	(嗅|齅)
齊	(亝|斉|斋|齋|齐|齊|斎)
齋	(斋|斎|齊|齋|亝|斉|齐)
齎	(賫|赍|齎)
齏	(韲|齑|齏)
齐	(齊|亝|斉|斋|齋|齐|斎)
齑	(齏|韲|齑)
齒	(歯|齿|齒)
齔	(龀|齔)
齕	(龁|齕)
齗	(龂|齗)
齙	(龅|齙)
齜	(龇|齜)
齟	(龃|齟)
齠	(龆|齠)
齡	(齢|龄|齡)
齢	(齡|齢|龄)
齦	(啃|龈|齦)
齧	(嚙|囓|啮|齧)
齩	(咬|齩)
齪	(龊|齪)
齬	(龉|齬)
齲	(龋|齲)
齶	(腭|齶)
齷	(龌|齷)
齿	(齒|歯|齿)
龀	(齔|龀)
龁	(齕|龁)
龂	(齗|龂)
龃	(齟|龃)
龄	(齡|齢|龄)
龅	(齙|龅)
龆	(齠|龆)
龇	(齜|龇)
龈	(齦|啃|龈)
龉	(齬|龉)
龊	(齪|龊)
龋	(齲|龋)
龌	(齷|龌)
龍	(尨|竜|龒|龙|龍|狵|龍)
龎	(厐|龐|龎|厖|庞|庬)
龐	(厐|厖|庞|龎|龐|庬)
龑	(䶮|龑)
龒	(龍|尨|竜|龒|龙|龍|狵)
龓	(䪊|龓)
龔	(龚|龔)
龕	(龛|龕)
龙	(龍|尨|竜|龒|龙|龍|狵)
龚	(龔|龚)
龛	(龕|龛)
龜	(亀|龟|龜|龜|龜)
龝	(䆋|秋|龝|秌|穐)
龞	(鱉|鳖|鼈|龞)
龟	(龜|亀|龟|龜|龜)
龠	(籥|龠)
龡	(吹|龡)
龢	(咊|和|龢)
龤	(諧|谐|龤)
龥	(籲|吁|龥)
龭	(𩨎|龭)
龯	(𨱆|龯)
鿁	(䜤|鿁)
鿌	(涼|凉|鿌|凉)
鿏	(䥑|鿏)
鿐	(䲤|鿐)
鿒	(鿓|鿒)
鿓	(鿒|鿓)
鿔	(鎶|鿔)
鿭	(鉨|鑈|鿭)
豈	(豈|岂|豈)
更	(更|㪅|更)
車	(車|车|車)
賈	(賈|贾|賈)
滑	(滑|磆|滑)
串	(串|串)
句	(句|勾|句)
龜	(龜|亀|龟|龜|龜)
龜	(龜|亀|龟|龜|龜)
契	(契|契)
金	(金|釒|钅|金)
喇	(喇|喇)
奈	(奈|柰|奈)
懶	(懶|嬾|懒|懶)
癩	(癩|癞|癩)
羅	(羅|罗|羅|囉|啰)
蘿	(蘿|萝|蘿)
螺	(螺|蠃|螺)
裸	(裸|躶|裸)
邏	(邏|逻|邏)
樂	(樂|乐|楽|樂|樂|樂)
洛	(洛|洛)
烙	(烙|烙)
珞	(珞|珞)
落	(落|落)
酪	(酪|酪)
駱	(駱|骆|駱)
亂	(亂|乱|亂)
卵	(卵|卵)
欄	(欄|栏|欄)
爛	(爛|烂|燗|爛)
蘭	(蘭|兰|蘭)
鸞	(鸞|鵉|鸾|鸞)
嵐	(嵐|岚|嵐)
濫	(濫|滥|濫)
藍	(藍|蓝|藍)
襤	(襤|繿|褴|襤|䍀|褓|緥)
拉	(拉|柆|拉)
臘	(臘|腊|臈|臘)
蠟	(蠟|蜡|蝋|蠟|䄍)
廊	(廊|廊)
朗	(朗|朖|朗)
浪	(浪|浪)
狼	(狼|狼)
郎	(郎|郞|郎)
來	(來|徠|来|耒|來|倈|勑|徕|俫|勅|敕)
冷	(冷|冷)
勞	(勞|劳|労|勞)
擄	(擄|掳|虜|擄|虏|虜)
櫓	(櫓|㯭|樐|橹|舮|舻|艣|艪|艫|櫓)
爐	(爐|炉|爐)
盧	(盧|卢|盧)
老	(老|耂|老)
蘆	(蘆|芦|蘆)
虜	(虜|擄|虏|虜|掳|擄)
路	(路|路)
露	(露|露)
魯	(魯|鲁|魯)
鷺	(鷺|鹭|鷺)
碌	(碌|碌)
祿	(祿|禄|祿)
綠	(綠|氯|緑|绿|綠)
菉	(菉|菉)
錄	(錄|录|録|錄)
鹿	(鹿|鹿)
論	(論|论|論)
壟	(壟|垄|壟)
弄	(弄|瘧|弄|疟)
籠	(籠|笼|篭|籠)
聾	(聾|聋|聾)
牢	(牢|牢)
磊	(磊|磥|磊)
賂	(賂|赂|賂)
雷	(雷|雷)
壘	(壘|垒|塁|壘)
屢	(屢|屡|屢)
樓	(樓|楼|樓)
淚	(淚|泪|涙|淚)
漏	(漏|漏)
累	(累|纍|累)
縷	(縷|缕|縷)
陋	(陋|陋)
勒	(勒|勒)
肋	(肋|肋)
凜	(凜|凛|凜|懔|懍)
凌	(凌|凌)
稜	(稜|棱|楞|稜)
綾	(綾|绫|綾)
菱	(菱|菱)
陵	(陵|陵)
讀	(讀|読|读|讀)
拏	(拏|拿|挐|拏)
樂	(樂|乐|楽|樂|樂|樂)
諾	(諾|诺|諾)
丹	(丹|丹)
寧	(寧|宁|寍|寕|寜|寧|寧|𡨴)
怒	(怒|怒)
率	(率|率|率)
異	(異|异|異)
北	(北|北)
磻	(磻|磻)
便	(便|便)
復	(復|复|複|覆|復)
不	(不|不)
泌	(泌|泌)
數	(數|数|數)
索	(索|索)
參	(參|叁|参|叄|叅|蓡|薓|參|三)
塞	(塞|塞)
省	(省|省)
葉	(葉|叶|葉)
說	(說|説|说|說|說)
殺	(殺|杀|殺)
辰	(辰|辰)
沈	(瀋|沈|沉|沈)
拾	(十|拾|拾)
若	(若|若)
掠	(掠|掠)
略	(略|畧|略)
亮	(亮|亮)
兩	(兩|両|两|兩)
凉	(涼|凉|鿌|凉)
梁	(梁|樑|梁)
糧	(糧|粮|糧)
良	(良|良)
諒	(諒|谅|諒)
量	(量|量)
勵	(勵|劢|励|勵|勱)
呂	(呂|吕|呂)
女	(女|女)
廬	(廬|庐|廬)
旅	(旅|旅)
濾	(濾|滤|濾)
礪	(礪|砺|礪)
閭	(閭|闾|閭)
驪	(驪|骊|驪)
麗	(麗|丽|麗)
黎	(黎|黎)
力	(力|力)
曆	(曆|历|厤|暦|歴|歷|曆|厲|歷|厉)
歷	(歷|历|曆|歴|歷|厲|厤|暦|曆|厉)
轢	(轢|轹|轢)
年	(年|年|秊|秊)
憐	(憐|怜|憐|怜)
戀	(戀|恋|戀)
撚	(撚|撚)
漣	(漣|涟|漣)
煉	(煉|炼|錬|煉)
璉	(璉|琏|璉)
秊	(年|秊|年|秊)
練	(練|练|練)
聯	(聯|联|聨|聫|聮|聯)
輦	(輦|襜|辇|輦|襝|裣)
蓮	(蓮|莲|蓮)
連	(連|连|連)
鍊	(鍊|鍊)
列	(列|列)
劣	(劣|劣)
咽	(咽|嚥|咽)
烈	(烈|烈)
裂	(裂|裂)
說	(說|説|说|說|說)
廉	(廉|亷|廉)
念	(念|念)
捻	(捻|捻)
殮	(殮|殓|殮)
簾	(簾|帘|簾|𢅏|𢅖|㡘)
獵	(獵|猎|猟|獵|𤢪)
令	(令|令)
囹	(囹|囹)
寧	(寧|宁|寍|寕|寜|寧|寧|𡨴)
嶺	(嶺|岭|嶺|岺)
怜	(怜|憐|怜|憐)
玲	(玲|玲)
瑩	(瑩|莹|瑩)
羚	(羚|羚)
聆	(聆|聆)
鈴	(鈴|铃|鈴)
零	(零|零)
靈	(靈|灵|霊|靈)
領	(領|领|領)
例	(例|例)
禮	(禮|礼|禮|礼)
醴	(醴|醴)
隸	(隸|隶|隷|隸)
惡	(惡|恶|悪|惡|噁)
了	(了|瞭|了|暸)
僚	(僚|僚)
寮	(寮|寮)
尿	(尿|氽|溺|脲|尿|氼|溺)
料	(料|料)
樂	(樂|乐|楽|樂|樂|樂)
燎	(燎|燎)
療	(療|疗|療)
蓼	(蓼|蓼)
遼	(遼|辽|遼)
龍	(龍|尨|竜|龒|龙|龍|狵)
暈	(暈|晕|暈)
阮	(阮|阮)
劉	(劉|刘|劉)
杻	(杻|杻)
柳	(柳|檉|柳|柽)
流	(流|流)
溜	(溜|澑|溜)
琉	(琉|瑠|璢|琉)
留	(留|畄|畱|留)
硫	(硫|硫)
紐	(紐|纽|紐)
類	(類|类|類|𩔗)
六	(六|陸|六|陆|陸)
戮	(戮|戮)
陸	(陸|六|陆|陸|六)
倫	(倫|伦|倫)
崙	(崙|侖|崘|崙|仑)
淪	(淪|沦|淪)
輪	(輪|轮|輪)
律	(律|律)
慄	(慄|栗|慄|栗)
栗	(栗|慄|慄|栗)
率	(率|率|率)
隆	(隆|隆)
利	(利|利|𥝢)
吏	(吏|吏)
履	(履|履)
易	(易|易)
李	(李|李)
梨	(梨|棃|梨)
泥	(泥|坭|泥)
理	(理|理)
痢	(痢|痢)
罹	(罹|罹)
裏	(裏|裡|里|裏|裡|里)
裡	(裏|裡|里|裏|裡|里)
里	(裏|里|裡|裏|裡|里)
離	(離|离|離)
匿	(匿|匿)
溺	(溺|尿|氼|溺|氽|脲|尿)
吝	(吝|恡|悋|吝)
燐	(燐|㷠|粦|燐)
璘	(璘|璘)
藺	(藺|蔺|藺)
隣	(鄰|邻|隣|隣)
鱗	(鱗|鳞|鱗)
麟	(麟|麐|麟)
林	(林|林)
淋	(淋|淋)
臨	(臨|临|臨)
立	(立|立)
笠	(笠|笠)
粒	(粒|粒)
狀	(狀|状|狀)
炙	(炙|炙)
識	(識|识|識)
什	(什|甚|什)
茶	(茶|茶)
刺	(刺|刾|莿|刺|㓨|朿)
切	(切|切)
度	(度|度|廓|廓)
拓	(拓|托|摭|拓)
糖	(糖|餹|糖)
宅	(宅|宅)
洞	(洞|峒|洞)
暴	(暴|虣|暴)
輻	(輻|辐|輻)
行	(行|行)
降	(降|夅|降)
見	(見|见|見)
廓	(度|廓|度|廓)
兀	(兀|兀)
嗀	(嗀|嗀)
塚	(塚|中|冢|塚)
晴	(晴|晴)
凞	(凞|凞)
猪	(猪|豬|猪)
益	(益|益)
礼	(礼|禮|礼|禮)
神	(神|神)
祥	(祥|祥)
福	(福|福)
靖	(靖|靖)
精	(精|精)
羽	(羽|羽)
蘒	(蘒|蘒)
諸	(諸|诸|諸)
﨣	(𧺯|﨣)
逸	(逸|逸)
都	(都|都)
飯	(飯|飰|饭|飯)
飼	(飼|飤|饲|飼)
館	(館|舘|馆|館)
鶴	(鶴|鹤|鶴)
𠂝	(眾|衆|众|𠂝)
𠂤	(堆|𣳨|𠂤)
𠆌	(庸|㐯|𠆌)
𠆲	(儣|𠆲)
𠆿	(𠌥|𠆿)
𠉂	(㒓|𠉂)
𠉗	(𠏢|𠉗)
𠊧	(併|倂|并|𠊧|並|幷|竝)
𠌥	(𠆿|𠌥)
𠏢	(𠉗|𠏢)
𠔃	(兮|𠔃)
𠕄	(凹|𠕄)
𠖥	(寵|宠|𠖥)
𠗦	(憑|凭|凴|𠗦)
𠚳	(𠠎|𠚳)
𠚹	(芟|𠚹)
𠛅	(剾|𠛅)
𠛆	(𠞆|𠛆)
𠜎	(鏾|𠜎)
𠜼	(掐|𠜼)
𠞆	(𠛆|𠞆)
𠞰	(剿|勦|𠞰)
𠠎	(𠚳|𠠎)
𠦌	(卌|𠦜|𠦌)
𠦜	(卌|𠦌|𠦜)
𠭴	(㑁|𠭴)
𠯗	(咂|𠯗)
𠯟	(哯|𠯟)
𠯠	(噅|噕|𠯠)
𠱓	(𠼮|𠱓)
𠱘	(𠸺|𠱘)
𠲥	(𡅏|𠲥)
𠲿	(欶|𠲿)
𠴢	(𡄔|𠴢)
𠵸	(𡄣|𠵸)
𠵾	(㗲|𠵾)
𠸺	(𠱘|𠸺)
𠼮	(𠱓|𠼮)
𡄔	(𠴢|𡄔)
𡄣	(𠵸|𡄣)
𡅈	(嚹|𡅈)
𡅏	(𠲥|𡅏)
𡈙	(囮|諤|𡈙|讍|谔)
𡋀	(𡓾|𡋀)
𡋗	(𡑭|𡋗)
𡑞	(隧|𡑞)
𡑭	(𡋗|𡑭)
𡒃	(隩|𡒃)
𡒄	(壈|𡒄)
𡓾	(𡋀|𡓾)
𡚁	(弊|𡚁)
𡜱	(嫉|𡜱)
𡝠	(㜷|𡝠)
𡞱	(㜢|𡞱)
𡞵	(㛟|𡞵)
𡞾	(嫩|嫰|媆|𡞾)
𡠹	(㛿|𡠹)
𡢃	(㛠|𡢃)
𡨴	(寧|宁|寍|寕|寜|寧|寧|𡨴)
𡭜	(𡮉|𡭜)
𡭬	(𡮣|𡭬)
𡮉	(𡭜|𡮉)
𡮣	(𡭬|𡮣)
𡱆	(属|屬|𡱆)
𡲕	(屜|屉|𡲕)
𡶴	(嵼|𡶴)
𡻕	(亗|岁|歲|𡻕|嵗|歳)
𡾱	(㟜|𡾱)
𢂑	(拭|𢂑)
𢅏	(㡘|簾|𢅏|帘|簾|𢅖)
𢅖	(簾|帘|簾|𢅏|𢅖|㡘)
𢆞	(䄯|𢆞)
𢊍	(㕑|厨|𢊍|廚)
𢋈	(㢝|𢋈)
𢍺	(弋|𢍺)
𢐧	(檠|𢐧)
𢕐	(渹|訇|𢕐|𥔀)
𢘝	(𢣚|𢘝)
𢘞	(𢣭|𢘞)
𢙓	(懀|𢙓)
𢙢	(恐|𢙢)
𢙱	(㑝|𢙱)
𢛯	(㦎|𢛯)
𢜫	(惺|醒|𢜫)
𢠳	(憋|𢠳)
𢠵	(惝|𢠵)
𢣚	(𢘝|𢣚)
𢣭	(𢘞|𢣭)
𢥠	(悚|𢥠)
𢫊	(𢷮|𢫊)
𢫞	(𢶫|𢫞)
𢫬	(摋|𢫬)
𢬦	(𢹿|𢬦)
𢭆	(抽|𢭆)
𢭏	(擣|搗|𢭏|捣)
𢯱	(搜|捜|𢯱|𢲷)
𢰾	(摠|總|搃|𢰾|总|捴|総|縂)
𢲷	(搜|捜|𢯱|𢲷)
𢳆	(摮|𢳆)
𢳜	(漇|𢳜)
𢶑	(𢸣|𢶑)
𢶣	(㩹|𢶣)
𢶫	(𢫞|𢶫)
𢷮	(𢫊|𢷮)
𢸣	(𢶑|𢸣)
𢹿	(𢬦|𢹿)
𢽾	(斅|敩|斆|𢽾|鏰|镚|錋)
𣁀	(𧥙|𣁀)
𣁚	(𣁟|𣁚)
𣁟	(𣁚|𣁟)
𣄈	(㫎|幑|𣄈)
𣆐	(曥|𣆐)
𣇀	(晡|𣇀)
𣉞	(暠|皜|𣉞)
𣍨	(𦢈|𣍨)
𣍯	(腪|𣍯)
𣍰	(脥|𣍰)
𣎑	(臗|𣎑)
𣐤	(欍|𣐤)
𣑶	(𣠲|𣑶)
𣓌	(槹|𣓌)
𣔼	(竿|𣔼)
𣗋	(欓|檔|𣗋|档)
𣘓	(𣞻|𣘓)
𣘴	(檭|𣘴)
𣘷	(𣝕|𣘷)
𣙎	(㭣|𣙎)
𣝕	(𣘷|𣝕)
𣞻	(𣘓|𣞻)
𣠲	(𣑶|𣠲)
𣦵	(歹|歺|𣦵|𣦶)
𣦶	(歹|歺|𣦵|𣦶)
𣭤	(𣯴|𣭤)
𣯴	(𣭤|𣯴)
𣳨	(𠂤|堆|𣳨)
𣶩	(澅|𣶩)
𣶫	(𣿉|𣶫)
𣸣	(濆|𣸣)
𣺼	(灙|𣺼)
𣺽	(𤁣|𣺽)
𣽷	(瀃|𣽷)
𣽽	(潸|𣽽)
𣾷	(㳢|𣾷)
𣿉	(𣶫|𣿉)
𤁣	(𣺽|𤁣)
𤆍	(赤|𤆍)
𤆡	(熓|𤆡)
𤇃	(爄|𤇃)
𤇄	(熌|𤇄)
𤈶	(熉|𤈶)
𤈷	(㷿|𤈷)
𤊀	(𤒎|𤊀)
𤋏	(熡|𤋏)
𤍠	(熱|热|𤍠)
𤎱	(纂|臇|𤎱)
𤑕	(熏|爋|燻|𤑕)
𤒎	(𤊀|𤒎)
𤕪	(爿|丬|𤕪)
𤕭	(将|將|𤕭|畺|疆)
𤕯	(漿|浆|𤕯)
𤞤	(玁|獫|𤞤|猃)
𤠋	(㺏|𤠋)
𤢕	(斁|𤢕)
𤢪	(獵|猎|猟|獵|𤢪)
𤦀	(瓕|𤦀)
𤧚	(璁|𤧚)
𤪺	(㻘|𤪺)
𤫩	(㻏|𤫩)
𤮨	(礱|砻|𤮨)
𤳄	(𤳸|𤳄)
𤳸	(𤳄|𤳸)
𤶧	(𤸫|𤶧)
𤸫	(𤶧|𤸫)
𤽯	(㿧|𤽯)
𤾀	(皟|𤾀)
𥁕	(昷|𥁕)
𥂁	(鹽|䀋|塩|盐|𥂁)
𥅘	(𥌃|𥅘)
𥅴	(䀹|睫|𥅴)
𥅾	(䚎|𥅾)
𥆧	(瞤|𥆧)
𥇢	(䁪|𥇢)
𥈟	(瞍|𥈟)
𥋟	(䂀|𥋟)
𥌃	(𥅘|𥌃)
𥐘	(石|𥐘)
𥐞	(硭|𥐞)
𥐟	(礒|𥐟)
𥐯	(𥖅|𥐯)
𥐰	(𥕥|𥐰)
𥐻	(碙|𥐻)
𥓿	(砣|鉈|𥓿|铊)
𥔀	(渹|訇|𢕐|𥔀)
𥕥	(𥐰|𥕥)
𥖅	(𥐯|𥖅)
𥜌	(澳|襖|𥜌|袄)
𥝢	(利|利|𥝢)
𥢢	(䅪|𥢢)
𥥅	(竉|䆔|𥥅)
𥧂	(𥨐|𥧂)
𥨐	(𥧂|𥨐)
𥫱	(囤|𥫱)
𥬀	(䉙|𥬀)
𥬞	(籋|𥬞)
𥬠	(篘|𥬠)
𥭉	(𥵊|𥭉)
𥮋	(𥸠|𥮋)
𥮜	(䉲|𥮜)
𥱔	(𥵃|𥱔)
𥵃	(𥱔|𥵃)
𥵊	(𥭉|𥵊)
𥵚	(竻|簕|𥵚)
𥸠	(𥮋|𥸠)
𥹥	(𥼽|𥹥)
𥺅	(䊭|𥺅)
𥺇	(𥽖|𥺇)
𥻟	(糯|稬|穤|粫|𥻟)
𥼽	(𥹥|𥼽)
𥽖	(𥺇|𥽖)
𥿊	(𦈈|𥿊)
𦀇	(經|経|经|𦀇)
𦂅	(𦈒|𦂅)
𦂳	(緊|紧|𦂳)
𦃄	(𦈗|𦃄)
𦈈	(𥿊|𦈈)
𦈉	(緷|𦈉)
𦈋	(綇|𦈋)
𦈌	(綀|𦈌)
𦈎	(繟|𦈎)
𦈏	(緍|𦈏)
𦈐	(縺|𦈐)
𦈑	(緸|𦈑)
𦈒	(𦂅|𦈒)
𦈓	(䋿|𦈓)
𦈔	(縎|𦈔)
𦈕	(緰|𦈕)
𦈖	(䌈|𦈖)
𦈗	(𦃄|𦈗)
𦈘	(䌋|𦈘)
𦈙	(䌰|𦈙)
𦈚	(縬|𦈚)
𦈛	(繓|𦈛)
𦈜	(䌖|𦈜)
𦈝	(繏|𦈝)
𦈞	(䌟|𦈞)
𦈟	(䌝|𦈟)
𦈠	(䌥|縯|𦈠)
𦈡	(繻|𦈡)
𦍩	(羖|𦍩)
𦕒	(䦓|覘|𦕒|觇)
𦙵	(腕|𦙵)
𦙶	(股|脵|𦙶)
𦙼	(骴|胔|𦙼)
𦚓	(胓|𦚓)
𦛨	(朥|𦛨)
𦝼	(膢|𦝼)
𦞣	(臊|𦞣)
𦟗	(𦣎|𦟗)
𦟤	(饈|䐰|馐|𦟤)
𦢈	(𣍨|𦢈)
𦢌	(殰|㱩|𦢌)
𦣎	(𦟗|𦣎)
𦤎	(臯|皋|𦤎|皐|睾)
𦨩	(𦪽|𦨩)
𦪽	(𦨩|𦪽)
𦰴	(䕳|𦰴)
𦱄	(菇|苽|菰|𦱄)
𦲷	(蒞|涖|莅|𦲷)
𦷝	(芻|刍|蒭|𦷝)
𦽊	(驊|骅|𦽊)
𧀹	(蔗|𧀹)
𧉞	(䗿|𧉞)
𧋍	(蜇|𧋍)
𧌓	(蛗|𧌓)
𧐅	(蛆|𧐅)
𧐢	(蠔|𧐢)
𧒭	(𧔥|𧒭)
𧔥	(𧒭|𧔥)
𧘂	(衝|冲|𧘂|沖|盅)
𧙀	(𧞪|𧙀)
𧜗	(䘞|𧜗)
𧜵	(䙊|𧜵)
𧝞	(䘛|𧝞)
𧞪	(𧙀|𧞪)
𧥙	(𣁀|𧥙)
𧩙	(䜥|誕|𧩙|诞)
𧬨	(噦|哕|𧬨)
𧮪	(詀|𧮪)
𧰊	(磌|𧰊)
𧳕	(𧳟|𧳕)
𧳟	(𧳕|𧳟)
𧴯	(孭|𧴯)
𧵳	(䞌|𧵳)
𧶔	(𧹓|𧶔)
𧶧	(䞎|𧶧)
𧶶	(販|贩|𧶶)
𧸖	(賺|贃|赚|𧸖|𧹗)
𧹑	(䞈|𧹑)
𧹓	(𧶔|𧹓)
𧹕	(䝻|𧹕)
𧹖	(賟|𧹖)
𧹗	(贃|賺|𧸖|𧹗|赚)
𧺯	(﨣|𧺯)
𧿈	(𨇁|𧿈)
𧿹	(拇|𧿹)
𨀱	(𨄣|𨀱)
𨁴	(𨅍|𨁴)
𨂺	(𨈊|𨂺)
𨃞	(𨃟|𨃞)
𨃟	(𨃞|𨃟)
𨄄	(𨈌|𨄄)
𨄣	(𨀱|𨄣)
𨅍	(𨁴|𨅍)
𨅫	(𨇞|𨅫)
𨅬	(躝|𨅬)
𨇁	(𧿈|𨇁)
𨇞	(𨅫|𨇞)
𨈊	(𨂺|𨈊)
𨈌	(𨄄|𨈌)
𨈚	(𨉉|𨈚)
𨉉	(𨈚|𨉉)
𨉗	(軉|𨉗)
𨊰	(䢀|𨊰)
𨊸	(䢁|𨊸)
𨊻	(𨐆|𨊻)
𨋢	(䢂|𨋢)
𨌩	(盪|逿|荡|蕩|蘯|𨌩|偒)
𨍳	(軺|轺|𨍳)
𨎮	(𨐉|𨎮)
𨏠	(𨐇|𨏠)
𨏥	(𨐊|𨏥)
𨐅	(軗|𨐅)
𨐆	(𨊻|𨐆)
𨐇	(𨏠|𨐇)
𨐈	(輄|𨐈)
𨐉	(𨎮|𨐉)
𨐊	(𨏥|𨐊)
𨑒	(徒|𨑒)
𨑹	(䢨|𨑹)
𨢥	(䤍|𨢥)
𨣦	(藇|𨣦)
𨤰	(𨤻|𨤰)
𨤻	(𨤰|𨤻)
𨥛	(𨱀|𨥛)
𨦫	(䦀|𨦫)
𨧜	(䦁|𨧜)
𨧱	(𨱊|𨧱)
𨫒	(𨱐|𨫒)
𨬕	(𨬟|𨬕)
𨬟	(𨬕|𨬟)
𨮂	(𨱕|𨮂)
𨯅	(䥿|𨯅)
𨰾	(鎷|𨰾)
𨰿	(釳|𨰿)
𨱀	(𨥛|𨱀)
𨱁	(鈠|𨱁)
𨱂	(鈋|𨱂)
𨱃	(鈲|𨱃)
𨱄	(鈯|𨱄)
𨱅	(鉁|𨱅)
𨱆	(龯|𨱆)
𨱇	(銶|𨱇)
𨱈	(鋉|𨱈)
𨱉	(鍄|𨱉)
𨱊	(𨧱|𨱊)
𨱋	(錂|𨱋)
𨱌	(鏆|𨱌)
𨱍	(鎯|𨱍)
𨱎	(鍮|𨱎)
𨱏	(鎝|𨱏)
𨱐	(𨫒|𨱐)
𨱑	(鐄|𨱑)
𨱒	(鏉|𨱒)
𨱓	(鐎|𨱓)
𨱔	(鐏|𨱔)
𨱕	(𨮂|𨱕)
𨱖	(䥩|𨱖)
𨳑	(𨸁|𨳑)
𨳕	(𨸀|𨳕)
𨴗	(𨸅|𨴗)
𨵩	(𨸆|𨵩)
𨵸	(𨸇|𨵸)
𨶀	(𨸉|𨶀)
𨶏	(𨸊|𨶏)
𨶮	(𨸌|𨶮)
𨶲	(𨸋|𨶲)
𨶹	(関|闗|關|𨶹|关|寡)
𨷲	(𨸎|𨷲)
𨷿	(䦳|𨷿)
𨸀	(𨳕|𨸀)
𨸁	(𨳑|𨸁)
𨸂	(閍|𨸂)
𨸃	(閐|𨸃)
𨸄	(䦘|𨸄)
𨸅	(𨴗|𨸅)
𨸆	(𨵩|𨸆)
𨸇	(𨵸|𨸇)
𨸉	(𨶀|𨸉)
𨸊	(𨶏|𨸊)
𨸋	(𨶲|𨸋)
𨸌	(𨶮|𨸌)
𨸎	(𨷲|𨸎)
𨸘	(𨽏|𨸘)
𨸚	(級|级|𨸚)
𨸟	(䧢|𨸟)
𨸬	(陣|阵|陳|𨸬|陈)
𨻲	(罅|𨻲)
𨽏	(𨸘|𨽏)
𩋘	(鞋|鞵|𩋘|𩋧)
𩋧	(鞋|鞵|𩋘|𩋧)
𩎢	(𩏾|𩎢)
𩏪	(𩏽|𩏪)
𩏼	(䪏|𩏼)
𩏽	(𩏪|𩏽)
𩏾	(𩎢|𩏾)
𩏿	(䪘|𩏿)
𩐀	(䪗|𩐀)
𩓣	(𩖕|𩓣)
𩔗	(類|类|類|𩔗)
𩖕	(𩓣|𩖕)
𩖖	(顃|𩖖)
𩖗	(䫴|𩖗)
𩗀	(𩙦|𩗀)
𩘀	(𩙩|𩘀)
𩘝	(𩙭|𩘝)
𩘹	(𩙨|𩘹)
𩘺	(𩙬|𩘺)
𩙈	(𩙰|𩙈)
𩙥	(颰|𩙥)
𩙦	(𩗀|𩙦)
𩙧	(䬞|𩙧)
𩙨	(𩘹|𩙨)
𩙩	(𩘀|𩙩)
𩙪	(颷|𩙪)
𩙫	(颾|𩙫)
𩙬	(𩘺|𩙬)
𩙭	(𩘝|𩙭)
𩙮	(䬘|𩙮)
𩙯	(䬝|𩙯)
𩙰	(𩙈|𩙰)
𩚛	(𩟿|𩚛)
𩚥	(𩠀|𩚥)
𩚵	(𩠁|𩚵)
𩛆	(𩠂|𩛆)
𩛩	(𩠃|𩛩)
𩜇	(𩠉|𩜇)
𩜦	(𩠆|𩜦)
𩜵	(𩠊|𩜵)
𩝔	(𩠋|𩝔)
𩞄	(𩠎|𩞄)
𩞦	(𩠏|𩞦)
𩞯	(䭪|𩞯)
𩟐	(𩠅|𩟐)
𩟿	(𩚛|𩟿)
𩠀	(𩚥|𩠀)
𩠁	(𩚵|𩠁)
𩠂	(𩛆|𩠂)
𩠃	(𩛩|𩠃)
𩠅	(𩟐|𩠅)
𩠆	(𩜦|𩠆)
𩠇	(䭀|𩠇)
𩠈	(䭃|𩠈)
𩠉	(𩜇|𩠉)
𩠊	(𩜵|𩠊)
𩠋	(𩝔|𩠋)
𩠌	(餸|𩠌)
𩠎	(𩞄|𩠎)
𩠏	(𩞦|𩠏)
𩠑	(頂|顶|𩠑)
𩠠	(𩠴|𩠠)
𩠴	(𩠠|𩠴)
𩡺	(𩧦|𩡺)
𩢡	(𩧬|𩢡)
𩢲	(駛|驶|𩢲)
𩢴	(𩧵|𩢴)
𩢸	(𩧳|𩢸)
𩢾	(𩧮|𩢾)
𩣏	(𩧶|𩣏)
𩣑	(䯃|𩣑)
𩣺	(𩧼|𩣺)
𩤊	(𩧩|𩤊)
𩤙	(𩨆|𩤙)
𩤲	(𩨉|𩤲)
𩤸	(𩨅|𩤸)
𩥄	(𩨋|𩥄)
𩥇	(𩨍|𩥇)
𩥉	(𩧱|𩥉)
𩥑	(𩨌|𩥑)
𩦢	(虞|𩦢)
𩧆	(𩨐|𩧆)
𩧦	(𩡺|𩧦)
𩧨	(駎|𩧨)
𩧩	(𩤊|𩧩)
𩧪	(䮾|𩧪)
𩧫	(駚|𩧫)
𩧬	(𩢡|𩧬)
𩧭	(䭿|𩧭)
𩧮	(𩢾|𩧮)
𩧯	(驋|𩧯)
𩧰	(䮝|𩧰)
𩧱	(𩥉|𩧱)
𩧲	(駧|𩧲)
𩧳	(𩢸|𩧳)
𩧴	(駩|𩧴)
𩧵	(𩢴|𩧵)
𩧶	(𩣏|𩧶)
𩧺	(駶|𩧺)
𩧼	(𩣺|𩧼)
𩧿	(䮠|𩧿)
𩨀	(騔|𩨀)
𩨁	(䮞|𩨁)
𩨃	(騝|𩨃)
𩨄	(騪|𩨄)
𩨅	(𩤸|𩨅)
𩨆	(𩤙|𩨆)
𩨇	(䮫|𩨇)
𩨈	(騟|𩨈)
𩨉	(𩤲|𩨉)
𩨊	(騚|𩨊)
𩨋	(𩥄|𩨋)
𩨌	(𩥑|𩨌)
𩨍	(𩥇|𩨍)
𩨎	(龭|𩨎)
𩨏	(䮳|𩨏)
𩨐	(𩧆|𩨐)
𩨘	(肐|胳|𩨘)
𩬣	(𩭙|𩬣)
𩬤	(𩰀|𩬤)
𩭙	(𩬣|𩭙)
𩯒	(𩯳|𩯒)
𩯭	(鬓|鬢|𩯭|鬂)
𩯳	(𩯒|𩯳)
𩰀	(𩬤|𩰀)
𩲒	(𩳤|𩲒)
𩳤	(𩲒|𩳤)
𩵩	(𩽺|𩵩)
𩵹	(𩽻|𩵹)
𩶘	(䲞|𩶘)
𩶰	(𩽿|𩶰)
𩶱	(𩽽|𩶱)
𩷰	(𩾄|𩷰)
𩸃	(𩾅|𩸃)
𩸦	(𩾆|𩸦)
𩽹	(魥|𩽹)
𩽺	(𩵩|𩽺)
𩽻	(𩵹|𩽻)
𩽼	(鯶|𩽼)
𩽽	(𩶱|𩽽)
𩽾	(鮟|𩽾)
𩽿	(𩶰|𩽿)
𩾁	(鯄|𩾁)
𩾂	(䲖|𩾂)
𩾃	(鮸|𩾃)
𩾄	(𩷰|𩾄)
𩾅	(𩸃|𩾅)
𩾆	(𩸦|𩾆)
𩾇	(鯱|𩾇)
𩾈	(䱙|𩾈)
𩾊	(䱬|𩾊)
𩾋	(䱰|𩾋)
𩾌	(鱇|𩾌)
𩿪	(𪉄|𩿪)
𪀦	(𪉅|𪀦)
𪀾	(𪉋|𪀾)
𪁈	(𪉉|𪁈)
𪁖	(𪉌|𪁖)
𪂆	(𪉎|𪂆)
𪃍	(𪉐|𪃍)
𪃏	(𪉏|𪃏)
𪄆	(𪉔|𪄆)
𪄕	(𪉒|𪄕)
𪇳	(𪉕|𪇳)
𪉂	(䲰|𪉂)
𪉃	(鳼|𪉃)
𪉄	(𩿪|𪉄)
𪉅	(𪀦|𪉅)
𪉆	(鴲|𪉆)
𪉈	(鴜|𪉈)
𪉉	(𪁈|𪉉)
𪉊	(鷨|𪉊)
𪉋	(𪀾|𪉋)
𪉌	(𪁖|𪉌)
𪉍	(鵚|𪉍)
𪉎	(𪂆|𪉎)
𪉏	(𪃏|𪉏)
𪉐	(𪃍|𪉐)
𪉑	(鷔|𪉑)
𪉒	(𪄕|𪉒)
𪉔	(𪄆|𪉔)
𪉕	(𪇳|𪉕)
𪋿	(𪎍|𪋿)
𪎈	(䴬|𪎈)
𪎉	(麲|𪎉)
𪎊	(麨|𪎊)
𪎋	(䴴|𪎋)
𪎍	(𪋿|𪎍)
𪔂	(鼎|𪔂)
𪔭	(𪔵|𪔭)
𪔵	(𪔭|𪔵)
𪖙	(齁|𪖙)
𪘀	(𪚏|𪘀)
𪘯	(𪚐|𪘯)
𪚏	(𪘀|𪚏)
𪚐	(𪘯|𪚐)
𪞝	(凙|𪞝)
𪡏	(嗹|𪡏)
𪢮	(圞|圝|𪢮)
𪨊	(㞞|𪨊)
𪨗	(屩|𫏋|蹺|𪨗|蹻|跷)
𪪝	(邕|雍|雝|𪪝|廱|簌)
𪻐	(瑽|𪻐)
𪾢	(睍|𪾢)
𫁡	(鴗|𫁡)
𫂈	(䉬|𫂈)
𫄨	(絺|𫄨)
𫄸	(纁|𫄸)
𫌀	(襀|𫌀)
𫌨	(覼|覙|𫌨)
𫍙	(訑|𫍙)
𫍟	(詑|𫍟)
𫍢	(譊|𫍢)
𫍰	(諰|𫍰)
𫍲	(謏|𫍲)
𫏋	(蹻|𪨗|蹺|𫏋|屩|跷)
𫐄	(軏|𫐄)
𫐆	(轣|𫐆)
𫐉	(軨|𫐉)
𫐐	(輗|𫐐)
𫐓	(輮|𫐓)
𫓧	(鈇|𫓧)
𫓩	(鏦|𫓩)
𫔎	(鐍|𫔎)
𫖸	(願|愿|𫖸)
𫗠	(餦|𫗠)
𫗦	(餔|𫗦)
𫗧	(餗|𫗧)
𫗮	(餭|𫗮)
𫗴	(饘|飦|𫗴)
𫘝	(駃|𫘝)
𫘣	(駻|𫘣)
𫘤	(騃|呆|𫘤|獃)
𫘨	(騠|𫘨)
𫚈	(鱮|𫚈)
𫚉	(魟|鰩|𫚉|鳐)
𫚒	(鮄|𫚒)
𫚔	(鮰|𫚔)
𫚕	(鰤|𫚕)
𫚙	(鯆|𫚙)
𫚭	(鱲|𫚭)
𫛛	(鳷|𫛛)
𫛞	(鴃|鵙|𫛞)
𫛢	(鸋|𫛢)
𫛶	(鶒|𫛶)
𫛸	(鶗|𫛸)
𫽮	(擋|攩|挡|𫽮)
𬑡	(瞅|矁|𬑡)
𬓼	(穨|𬓼)
𬘭	(綝|𬘭)
𬤥	(譔|𬤥)
𬯎	(隤|墤|𬯎)
𬸣	(鶱|𬸣)
𭀖	(厘|釐|𭀖)
冗	(冗|宂|冗)
灰	(灰|灰)
冒	(冒|冐|冒)
